Date,Season,Week,Festive Period,Control Point,Arrival/Departure,Hong Kong Residents,Mainland Visitors,Other Visitors,Total
4/4/2019,Q2,5,D,Airport,Arrival,29331,15048,32239,76618
4/4/2019,Q2,5,D,Airport,Departure,48963,11905,21276,82144
4/4/2019,Q2,5,D,Express Rail Link West Kowloon,Arrival,7063,17165,1557,25785
4/4/2019,Q2,5,D,Express Rail Link West Kowloon,Departure,20618,9134,873,30625
4/4/2019,Q2,5,D,Hung Hom,Arrival,1871,1123,402,3396
4/4/2019,Q2,5,D,Hung Hom,Departure,4581,920,318,5819
4/4/2019,Q2,5,D,Lo Wu,Arrival,75438,22606,1957,100001
4/4/2019,Q2,5,D,Lo Wu,Departure,158537,24415,1933,184885
4/4/2019,Q2,5,D,Lok Ma Chau Spur Line,Arrival,45863,21225,894,67982
4/4/2019,Q2,5,D,Lok Ma Chau Spur Line,Departure,64735,19131,655,84521
4/4/2019,Q2,5,D,Hong Kong-Zhuhai-Macao Bridge,Arrival,10268,7215,3396,20879
4/4/2019,Q2,5,D,Hong Kong-Zhuhai-Macao Bridge,Departure,23082,9213,3886,36181
4/4/2019,Q2,5,D,Lok Ma Chau,Arrival,24220,9707,1557,35484
4/4/2019,Q2,5,D,Lok Ma Chau,Departure,32913,6883,873,40669
4/4/2019,Q2,5,D,Man Kam To,Arrival,3538,1601,42,5181
4/4/2019,Q2,5,D,Man Kam To,Departure,4715,1341,57,6113
4/4/2019,Q2,5,D,Sha Tau Kok,Arrival,3035,873,214,4122
4/4/2019,Q2,5,D,Sha Tau Kok,Departure,5414,784,116,6314
4/4/2019,Q2,5,D,Shenzhen Bay,Arrival,28058,18747,2348,49153
4/4/2019,Q2,5,D,Shenzhen Bay,Departure,58317,18170,1523,78010
4/4/2019,Q2,5,D,China Ferry Terminal,Arrival,2617,1448,1621,5686
4/4/2019,Q2,5,D,China Ferry Terminal,Departure,6263,1742,1534,9539
4/4/2019,Q2,5,D,Harbour Control,Arrival,1,0,156,157
4/4/2019,Q2,5,D,Harbour Control,Departure,2,0,7,9
4/4/2019,Q2,5,D,Kai Tak Cruise Terminal,Arrival,622,173,28,823
4/4/2019,Q2,5,D,Kai Tak Cruise Terminal,Departure,578,135,60,773
4/4/2019,Q2,5,D,Macau Ferry Terminal,Arrival,9137,3465,4667,17269
4/4/2019,Q2,5,D,Macau Ferry Terminal,Departure,12921,1413,3968,18302
4/4/2019,Q2,5,D,Tuen Mun Ferry Terminal,Arrival,579,11,32,622
4/4/2019,Q2,5,D,Tuen Mun Ferry Terminal,Departure,882,19,19,920
4/5/2019,Q2,5,D,Airport,Arrival,26473,15022,28019,69514
4/5/2019,Q2,5,D,Airport,Departure,36156,10175,21923,68254
4/5/2019,Q2,5,D,Express Rail Link West Kowloon,Arrival,8611,39301,2005,49917
4/5/2019,Q2,5,D,Express Rail Link West Kowloon,Departure,19026,20803,1028,40857
4/5/2019,Q2,5,D,Hung Hom,Arrival,2820,2406,513,5739
4/5/2019,Q2,5,D,Hung Hom,Departure,5245,1205,341,6791
4/5/2019,Q2,5,D,Lo Wu,Arrival,116763,48377,2332,167472
4/5/2019,Q2,5,D,Lo Wu,Departure,126522,49229,2165,177916
4/5/2019,Q2,5,D,Lok Ma Chau Spur Line,Arrival,57172,54625,1047,112844
4/5/2019,Q2,5,D,Lok Ma Chau Spur Line,Departure,64797,45106,793,110696
4/5/2019,Q2,5,D,Hong Kong-Zhuhai-Macao Bridge,Arrival,21630,13976,5692,41298
4/5/2019,Q2,5,D,Hong Kong-Zhuhai-Macao Bridge,Departure,30200,17421,5440,53061
4/5/2019,Q2,5,D,Lok Ma Chau,Arrival,31161,12980,1262,45403
4/5/2019,Q2,5,D,Lok Ma Chau,Departure,31262,12183,832,44277
4/5/2019,Q2,5,D,Man Kam To,Arrival,2251,4203,91,6545
4/5/2019,Q2,5,D,Man Kam To,Departure,2772,2678,61,5511
4/5/2019,Q2,5,D,Sha Tau Kok,Arrival,4227,2097,165,6489
4/5/2019,Q2,5,D,Sha Tau Kok,Departure,5077,1289,78,6444
4/5/2019,Q2,5,D,Shenzhen Bay,Arrival,40928,40828,2188,83944
4/5/2019,Q2,5,D,Shenzhen Bay,Departure,49773,34222,1506,85501
4/5/2019,Q2,5,D,China Ferry Terminal,Arrival,3607,3088,1632,8327
4/5/2019,Q2,5,D,China Ferry Terminal,Departure,7095,2258,1601,10954
4/5/2019,Q2,5,D,Harbour Control,Arrival,23,0,140,163
4/5/2019,Q2,5,D,Harbour Control,Departure,1,4,6,11
4/5/2019,Q2,5,D,Kai Tak Cruise Terminal,Arrival,1071,3598,870,5539
4/5/2019,Q2,5,D,Kai Tak Cruise Terminal,Departure,3543,3971,344,7858
4/5/2019,Q2,5,D,Macau Ferry Terminal,Arrival,13230,2094,5888,21212
4/5/2019,Q2,5,D,Macau Ferry Terminal,Departure,14860,2114,3883,20857
4/5/2019,Q2,5,D,Tuen Mun Ferry Terminal,Arrival,1190,21,61,1272
4/5/2019,Q2,5,D,Tuen Mun Ferry Terminal,Departure,1500,21,34,1555
4/6/2019,Q2,5,D,Airport,Arrival,33868,11514,25451,70833
4/6/2019,Q2,5,D,Airport,Departure,26966,12658,25204,64828
4/6/2019,Q2,5,D,Express Rail Link West Kowloon,Arrival,13517,32986,1439,47942
4/6/2019,Q2,5,D,Express Rail Link West Kowloon,Departure,8403,29049,1166,38618
4/6/2019,Q2,5,D,Hung Hom,Arrival,3099,1630,348,5077
4/6/2019,Q2,5,D,Hung Hom,Departure,2222,2039,378,4639
4/6/2019,Q2,5,D,Lo Wu,Arrival,107995,46596,2360,156951
4/6/2019,Q2,5,D,Lo Wu,Departure,91518,58985,2567,153070
4/6/2019,Q2,5,D,Lok Ma Chau Spur Line,Arrival,49496,57220,1021,107737
4/6/2019,Q2,5,D,Lok Ma Chau Spur Line,Departure,51143,57912,986,110041
4/6/2019,Q2,5,D,Hong Kong-Zhuhai-Macao Bridge,Arrival,20781,15792,4833,41406
4/6/2019,Q2,5,D,Hong Kong-Zhuhai-Macao Bridge,Departure,19254,17894,4790,41938
4/6/2019,Q2,5,D,Lok Ma Chau,Arrival,29620,11672,814,42106
4/6/2019,Q2,5,D,Lok Ma Chau,Departure,23474,12666,1073,37213
4/6/2019,Q2,5,D,Man Kam To,Arrival,2001,4264,35,6300
4/6/2019,Q2,5,D,Man Kam To,Departure,2013,3294,38,5345
4/6/2019,Q2,5,D,Sha Tau Kok,Arrival,3069,1996,130,5195
4/6/2019,Q2,5,D,Sha Tau Kok,Departure,2685,1553,164,4402
4/6/2019,Q2,5,D,Shenzhen Bay,Arrival,37567,41015,1942,80524
4/6/2019,Q2,5,D,Shenzhen Bay,Departure,30135,42571,2256,74962
4/6/2019,Q2,5,D,China Ferry Terminal,Arrival,4514,2796,1679,8989
4/6/2019,Q2,5,D,China Ferry Terminal,Departure,3318,3523,1667,8508
4/6/2019,Q2,5,D,Harbour Control,Arrival,8,0,46,54
4/6/2019,Q2,5,D,Harbour Control,Departure,1,2,12,15
4/6/2019,Q2,5,D,Kai Tak Cruise Terminal,Arrival,624,339,35,998
4/6/2019,Q2,5,D,Kai Tak Cruise Terminal,Departure,831,230,682,1743
4/6/2019,Q2,5,D,Macau Ferry Terminal,Arrival,12723,2325,5293,20341
4/6/2019,Q2,5,D,Macau Ferry Terminal,Departure,11907,2510,4803,19220
4/6/2019,Q2,5,D,Tuen Mun Ferry Terminal,Arrival,923,49,57,1029
4/6/2019,Q2,5,D,Tuen Mun Ferry Terminal,Departure,906,32,34,972
4/7/2019,Q2,5,D,Airport,Arrival,51416,13499,22178,87093
4/7/2019,Q2,5,D,Airport,Departure,29332,16547,33015,78894
4/7/2019,Q2,5,D,Express Rail Link West Kowloon,Arrival,23788,14291,878,38957
4/7/2019,Q2,5,D,Express Rail Link West Kowloon,Departure,5177,28620,1892,35689
4/7/2019,Q2,5,D,Hung Hom,Arrival,5437,1404,293,7134
4/7/2019,Q2,5,D,Hung Hom,Departure,1546,2074,556,4176
4/7/2019,Q2,5,D,Lo Wu,Arrival,146316,26313,1774,174403
4/7/2019,Q2,5,D,Lo Wu,Departure,69191,33734,2227,105152
4/7/2019,Q2,5,D,Lok Ma Chau Spur Line,Arrival,62183,27444,607,90234
4/7/2019,Q2,5,D,Lok Ma Chau Spur Line,Departure,36968,31131,1046,69145
4/7/2019,Q2,5,D,Hong Kong-Zhuhai-Macao Bridge,Arrival,31494,9876,4156,45526
4/7/2019,Q2,5,D,Hong Kong-Zhuhai-Macao Bridge,Departure,14405,12006,4923,31334
4/7/2019,Q2,5,D,Lok Ma Chau,Arrival,39200,10546,692,50438
4/7/2019,Q2,5,D,Lok Ma Chau,Departure,18645,10640,1832,31117
4/7/2019,Q2,5,D,Man Kam To,Arrival,2817,2428,36,5281
4/7/2019,Q2,5,D,Man Kam To,Departure,1516,2088,50,3654
4/7/2019,Q2,5,D,Sha Tau Kok,Arrival,4531,1263,70,5864
4/7/2019,Q2,5,D,Sha Tau Kok,Departure,2280,1247,193,3720
4/7/2019,Q2,5,D,Shenzhen Bay,Arrival,58655,21734,1313,81702
4/7/2019,Q2,5,D,Shenzhen Bay,Departure,22973,29817,3102,55892
4/7/2019,Q2,5,D,China Ferry Terminal,Arrival,7271,1807,1193,10271
4/7/2019,Q2,5,D,China Ferry Terminal,Departure,2272,2427,1793,6492
4/7/2019,Q2,5,D,Harbour Control,Arrival,1,0,84,85
4/7/2019,Q2,5,D,Harbour Control,Departure,1,1,26,28
4/7/2019,Q2,5,D,Kai Tak Cruise Terminal,Arrival,3748,771,2265,6784
4/7/2019,Q2,5,D,Kai Tak Cruise Terminal,Departure,487,977,61,1525
4/7/2019,Q2,5,D,Macau Ferry Terminal,Arrival,14749,1718,3679,20146
4/7/2019,Q2,5,D,Macau Ferry Terminal,Departure,8350,1418,4496,14264
4/7/2019,Q2,5,D,Tuen Mun Ferry Terminal,Arrival,1120,56,36,1212
4/7/2019,Q2,5,D,Tuen Mun Ferry Terminal,Departure,743,29,37,809
4/18/2019,Q2,5,C,Airport,Arrival,37783,12809,27943,78535
4/18/2019,Q2,5,C,Airport,Departure,80346,6535,17371,104252
4/18/2019,Q2,5,C,Express Rail Link West Kowloon,Arrival,7463,14217,2257,23937
4/18/2019,Q2,5,C,Express Rail Link West Kowloon,Departure,31938,14298,1646,47882
4/18/2019,Q2,5,C,Hung Hom,Arrival,1545,1167,691,3403
4/18/2019,Q2,5,C,Hung Hom,Departure,3916,1183,384,5483
4/18/2019,Q2,5,C,Lo Wu,Arrival,73239,24496,1856,99591
4/18/2019,Q2,5,C,Lo Wu,Departure,122524,28958,2190,153672
4/18/2019,Q2,5,C,Lok Ma Chau Spur Line,Arrival,41032,21305,827,63164
4/18/2019,Q2,5,C,Lok Ma Chau Spur Line,Departure,63481,20216,757,84454
4/18/2019,Q2,5,C,Hong Kong-Zhuhai-Macao Bridge,Arrival,12686,9453,4795,26934
4/18/2019,Q2,5,C,Hong Kong-Zhuhai-Macao Bridge,Departure,27928,26476,4704,59108
4/18/2019,Q2,5,C,Lok Ma Chau,Arrival,22798,15944,1440,40182
4/18/2019,Q2,5,C,Lok Ma Chau,Departure,30783,11279,1250,43312
4/18/2019,Q2,5,C,Man Kam To,Arrival,2398,2425,34,4857
4/18/2019,Q2,5,C,Man Kam To,Departure,3160,1705,47,4912
4/18/2019,Q2,5,C,Sha Tau Kok,Arrival,1985,874,109,2968
4/18/2019,Q2,5,C,Sha Tau Kok,Departure,3248,841,100,4189
4/18/2019,Q2,5,C,Shenzhen Bay,Arrival,25395,18373,2236,46004
4/18/2019,Q2,5,C,Shenzhen Bay,Departure,51346,22183,1935,75464
4/18/2019,Q2,5,C,China Ferry Terminal,Arrival,2657,1357,1632,5646
4/18/2019,Q2,5,C,China Ferry Terminal,Departure,5548,1973,1763,9284
4/18/2019,Q2,5,C,Harbour Control,Arrival,15,2,97,114
4/18/2019,Q2,5,C,Harbour Control,Departure,3,3,31,37
4/18/2019,Q2,5,C,Kai Tak Cruise Terminal,Arrival,677,3276,103,4056
4/18/2019,Q2,5,C,Kai Tak Cruise Terminal,Departure,4494,438,172,5104
4/18/2019,Q2,5,C,Macau Ferry Terminal,Arrival,10586,1261,4806,16653
4/18/2019,Q2,5,C,Macau Ferry Terminal,Departure,15661,1531,4522,21714
4/18/2019,Q2,5,C,Tuen Mun Ferry Terminal,Arrival,824,15,41,880
4/18/2019,Q2,5,C,Tuen Mun Ferry Terminal,Departure,1013,14,24,1051
4/19/2019,Q2,5,C,Airport,Arrival,32979,12242,30750,75971
4/19/2019,Q2,5,C,Airport,Departure,73456,7406,21236,102098
4/19/2019,Q2,5,C,Express Rail Link West Kowloon,Arrival,7724,11831,2691,22246
4/19/2019,Q2,5,C,Express Rail Link West Kowloon,Departure,47759,9999,998,58756
4/19/2019,Q2,5,C,Hung Hom,Arrival,1483,1207,1007,3697
4/19/2019,Q2,5,C,Hung Hom,Departure,7147,765,258,8170
4/19/2019,Q2,5,C,Lo Wu,Arrival,84852,18499,2155,105506
4/19/2019,Q2,5,C,Lo Wu,Departure,184063,21549,2415,208027
4/19/2019,Q2,5,C,Lok Ma Chau Spur Line,Arrival,48534,16086,769,65389
4/19/2019,Q2,5,C,Lok Ma Chau Spur Line,Departure,114018,14541,702,129261
4/19/2019,Q2,5,C,Hong Kong-Zhuhai-Macao Bridge,Arrival,18963,8731,6901,34595
4/19/2019,Q2,5,C,Hong Kong-Zhuhai-Macao Bridge,Departure,57076,20711,5726,83513
4/19/2019,Q2,5,C,Lok Ma Chau,Arrival,24777,10659,1734,37170
4/19/2019,Q2,5,C,Lok Ma Chau,Departure,39692,7582,1129,48403
4/19/2019,Q2,5,C,Man Kam To,Arrival,1323,1648,46,3017
4/19/2019,Q2,5,C,Man Kam To,Departure,3416,1336,126,4878
4/19/2019,Q2,5,C,Sha Tau Kok,Arrival,1759,592,142,2493
4/19/2019,Q2,5,C,Sha Tau Kok,Departure,4770,559,116,5445
4/19/2019,Q2,5,C,Shenzhen Bay,Arrival,24803,13266,2772,40841
4/19/2019,Q2,5,C,Shenzhen Bay,Departure,72830,13754,1665,88249
4/19/2019,Q2,5,C,China Ferry Terminal,Arrival,2778,1217,1850,5845
4/19/2019,Q2,5,C,China Ferry Terminal,Departure,10636,1421,1417,13474
4/19/2019,Q2,5,C,Harbour Control,Arrival,1,0,104,105
4/19/2019,Q2,5,C,Harbour Control,Departure,0,0,3,3
4/19/2019,Q2,5,C,Kai Tak Cruise Terminal,Arrival,1001,3043,47,4091
4/19/2019,Q2,5,C,Kai Tak Cruise Terminal,Departure,3879,728,631,5238
4/19/2019,Q2,5,C,Macau Ferry Terminal,Arrival,13216,1321,5367,19904
4/19/2019,Q2,5,C,Macau Ferry Terminal,Departure,21872,1487,4687,28046
4/19/2019,Q2,5,C,Tuen Mun Ferry Terminal,Arrival,1049,6,97,1152
4/19/2019,Q2,5,C,Tuen Mun Ferry Terminal,Departure,1791,25,23,1839
4/20/2019,Q2,5,C,Airport,Arrival,43572,12896,25898,82366
4/20/2019,Q2,5,C,Airport,Departure,44172,10732,28831,83735
4/20/2019,Q2,5,C,Express Rail Link West Kowloon,Arrival,12396,19531,2552,34479
4/20/2019,Q2,5,C,Express Rail Link West Kowloon,Departure,24175,15840,1402,41417
4/20/2019,Q2,5,C,Hung Hom,Arrival,2163,1251,648,4062
4/20/2019,Q2,5,C,Hung Hom,Departure,4594,1000,438,6032
4/20/2019,Q2,5,C,Lo Wu,Arrival,96913,30500,2665,130078
4/20/2019,Q2,5,C,Lo Wu,Departure,120410,31567,2312,154289
4/20/2019,Q2,5,C,Lok Ma Chau Spur Line,Arrival,53428,33666,982,88076
4/20/2019,Q2,5,C,Lok Ma Chau Spur Line,Departure,69004,30732,711,100447
4/20/2019,Q2,5,C,Hong Kong-Zhuhai-Macao Bridge,Arrival,29980,15847,5741,51568
4/20/2019,Q2,5,C,Hong Kong-Zhuhai-Macao Bridge,Departure,36536,22396,5715,64647
4/20/2019,Q2,5,C,Lok Ma Chau,Arrival,29161,13079,1522,43762
4/20/2019,Q2,5,C,Lok Ma Chau,Departure,25983,10404,1056,37443
4/20/2019,Q2,5,C,Man Kam To,Arrival,1547,3188,77,4812
4/20/2019,Q2,5,C,Man Kam To,Departure,2007,1809,24,3840
4/20/2019,Q2,5,C,Sha Tau Kok,Arrival,2430,1122,184,3736
4/20/2019,Q2,5,C,Sha Tau Kok,Departure,3397,918,82,4397
4/20/2019,Q2,5,C,Shenzhen Bay,Arrival,33155,27043,2906,63104
4/20/2019,Q2,5,C,Shenzhen Bay,Departure,45603,27062,1764,74429
4/20/2019,Q2,5,C,China Ferry Terminal,Arrival,4449,1503,1498,7450
4/20/2019,Q2,5,C,China Ferry Terminal,Departure,6131,1505,1624,9260
4/20/2019,Q2,5,C,Harbour Control,Arrival,2,1,159,162
4/20/2019,Q2,5,C,Harbour Control,Departure,0,0,15,15
4/20/2019,Q2,5,C,Kai Tak Cruise Terminal,Arrival,911,192,3812,4915
4/20/2019,Q2,5,C,Kai Tak Cruise Terminal,Departure,763,371,27,1161
4/20/2019,Q2,5,C,Macau Ferry Terminal,Arrival,17119,1278,4844,23241
4/20/2019,Q2,5,C,Macau Ferry Terminal,Departure,16922,1643,4847,23412
4/20/2019,Q2,5,C,Tuen Mun Ferry Terminal,Arrival,1395,14,46,1455
4/20/2019,Q2,5,C,Tuen Mun Ferry Terminal,Departure,1285,24,43,1352
4/21/2019,Q2,5,C,Airport,Arrival,59308,11766,23072,94146
4/21/2019,Q2,5,C,Airport,Departure,39595,12921,34322,86838
4/21/2019,Q2,5,C,Express Rail Link West Kowloon,Arrival,26608,14750,1437,42795
4/21/2019,Q2,5,C,Express Rail Link West Kowloon,Departure,13050,18736,2042,33828
4/21/2019,Q2,5,C,Hung Hom,Arrival,5777,1235,355,7367
4/21/2019,Q2,5,C,Hung Hom,Departure,2079,1287,574,3940
4/21/2019,Q2,5,C,Lo Wu,Arrival,146295,29269,2410,177974
4/21/2019,Q2,5,C,Lo Wu,Departure,96370,35486,2580,134436
4/21/2019,Q2,5,C,Lok Ma Chau Spur Line,Arrival,77898,36318,872,115088
4/21/2019,Q2,5,C,Lok Ma Chau Spur Line,Departure,59928,33836,1011,94775
4/21/2019,Q2,5,C,Hong Kong-Zhuhai-Macao Bridge,Arrival,44425,14458,5691,64574
4/21/2019,Q2,5,C,Hong Kong-Zhuhai-Macao Bridge,Departure,32780,20520,7052,60352
4/21/2019,Q2,5,C,Lok Ma Chau,Arrival,41619,15990,979,58588
4/21/2019,Q2,5,C,Lok Ma Chau,Departure,24702,13886,1588,40176
4/21/2019,Q2,5,C,Man Kam To,Arrival,2517,5454,127,8098
4/21/2019,Q2,5,C,Man Kam To,Departure,1678,2517,52,4247
4/21/2019,Q2,5,C,Sha Tau Kok,Arrival,3729,1172,99,5000
4/21/2019,Q2,5,C,Sha Tau Kok,Departure,2786,1078,150,4014
4/21/2019,Q2,5,C,Shenzhen Bay,Arrival,66178,23812,1869,91859
4/21/2019,Q2,5,C,Shenzhen Bay,Departure,34068,30006,2645,66719
4/21/2019,Q2,5,C,China Ferry Terminal,Arrival,7999,1014,1156,10169
4/21/2019,Q2,5,C,China Ferry Terminal,Departure,4595,1681,1679,7955
4/21/2019,Q2,5,C,Harbour Control,Arrival,1,0,161,162
4/21/2019,Q2,5,C,Harbour Control,Departure,10,0,5,15
4/21/2019,Q2,5,C,Kai Tak Cruise Terminal,Arrival,3827,922,996,5745
4/21/2019,Q2,5,C,Kai Tak Cruise Terminal,Departure,2858,491,3093,6442
4/21/2019,Q2,5,C,Macau Ferry Terminal,Arrival,21289,1248,4414,26951
4/21/2019,Q2,5,C,Macau Ferry Terminal,Departure,17532,1427,5153,24112
4/21/2019,Q2,5,C,Tuen Mun Ferry Terminal,Arrival,1481,21,46,1548
4/21/2019,Q2,5,C,Tuen Mun Ferry Terminal,Departure,1462,13,59,1534
4/22/2019,Q2,5,C,Airport,Arrival,82658,7251,17195,107104
4/22/2019,Q2,5,C,Airport,Departure,45399,9743,28011,83153
4/22/2019,Q2,5,C,Express Rail Link West Kowloon,Arrival,39940,9638,1082,50660
4/22/2019,Q2,5,C,Express Rail Link West Kowloon,Departure,8266,7955,2418,18639
4/22/2019,Q2,5,C,Hung Hom,Arrival,5440,840,277,6557
4/22/2019,Q2,5,C,Hung Hom,Departure,1598,743,1256,3597
4/22/2019,Q2,5,C,Lo Wu,Arrival,162235,22507,2020,186762
4/22/2019,Q2,5,C,Lo Wu,Departure,75943,19584,1992,97519
4/22/2019,Q2,5,C,Lok Ma Chau Spur Line,Arrival,89471,19877,687,110035
4/22/2019,Q2,5,C,Lok Ma Chau Spur Line,Departure,47412,13919,616,61947
4/22/2019,Q2,5,C,Hong Kong-Zhuhai-Macao Bridge,Arrival,45025,10285,4357,59667
4/22/2019,Q2,5,C,Hong Kong-Zhuhai-Macao Bridge,Departure,19365,24762,5895,50022
4/22/2019,Q2,5,C,Lok Ma Chau,Arrival,49762,14631,954,65347
4/22/2019,Q2,5,C,Lok Ma Chau,Departure,20822,7209,1341,29372
4/22/2019,Q2,5,C,Man Kam To,Arrival,2800,2580,34,5414
4/22/2019,Q2,5,C,Man Kam To,Departure,1521,1166,18,2705
4/22/2019,Q2,5,C,Sha Tau Kok,Arrival,4266,694,74,5034
4/22/2019,Q2,5,C,Sha Tau Kok,Departure,2225,463,109,2797
4/22/2019,Q2,5,C,Shenzhen Bay,Arrival,70670,14154,1618,86442
4/22/2019,Q2,5,C,Shenzhen Bay,Departure,25069,12556,2107,39732
4/22/2019,Q2,5,C,China Ferry Terminal,Arrival,9496,1060,1042,11598
4/22/2019,Q2,5,C,China Ferry Terminal,Departure,2842,1123,1567,5532
4/22/2019,Q2,5,C,Harbour Control,Arrival,2,44,87,133
4/22/2019,Q2,5,C,Harbour Control,Departure,0,45,5,50
4/22/2019,Q2,5,C,Kai Tak Cruise Terminal,Arrival,643,368,27,1038
4/22/2019,Q2,5,C,Kai Tak Cruise Terminal,Departure,493,318,1386,2197
4/22/2019,Q2,5,C,Macau Ferry Terminal,Arrival,23368,1199,3868,28435
4/22/2019,Q2,5,C,Macau Ferry Terminal,Departure,9550,1221,4086,14857
4/22/2019,Q2,5,C,Tuen Mun Ferry Terminal,Arrival,1546,12,43,1601
4/22/2019,Q2,5,C,Tuen Mun Ferry Terminal,Departure,787,20,49,856
4/30/2019,Q2,5,E,Airport,Arrival,35253,18469,25397,79119
4/30/2019,Q2,5,E,Airport,Departure,25858,23605,27297,76760
4/30/2019,Q2,5,E,Express Rail Link West Kowloon,Arrival,7720,23753,1677,33150
4/30/2019,Q2,5,E,Express Rail Link West Kowloon,Departure,5485,13655,1827,20967
4/30/2019,Q2,5,E,Hung Hom,Arrival,2317,2007,401,4725
4/30/2019,Q2,5,E,Hung Hom,Departure,1837,1469,1361,4667
4/30/2019,Q2,5,E,Lo Wu,Arrival,80230,31198,2264,113692
4/30/2019,Q2,5,E,Lo Wu,Departure,92340,28058,2163,122561
4/30/2019,Q2,5,E,Lok Ma Chau Spur Line,Arrival,47800,26062,853,74715
4/30/2019,Q2,5,E,Lok Ma Chau Spur Line,Departure,51565,20598,576,72739
4/30/2019,Q2,5,E,Hong Kong-Zhuhai-Macao Bridge,Arrival,11523,10152,3390,25065
4/30/2019,Q2,5,E,Hong Kong-Zhuhai-Macao Bridge,Departure,12047,13241,3406,28694
4/30/2019,Q2,5,E,Lok Ma Chau,Arrival,25022,12827,1755,39604
4/30/2019,Q2,5,E,Lok Ma Chau,Departure,25689,9158,974,35821
4/30/2019,Q2,5,E,Man Kam To,Arrival,3429,2289,61,5779
4/30/2019,Q2,5,E,Man Kam To,Departure,3815,1661,47,5523
4/30/2019,Q2,5,E,Sha Tau Kok,Arrival,2891,1366,177,4434
4/30/2019,Q2,5,E,Sha Tau Kok,Departure,2911,849,85,3845
4/30/2019,Q2,5,E,Shenzhen Bay,Arrival,31337,27070,2350,60757
4/30/2019,Q2,5,E,Shenzhen Bay,Departure,29728,20107,1764,51599
4/30/2019,Q2,5,E,China Ferry Terminal,Arrival,2630,2159,1831,6620
4/30/2019,Q2,5,E,China Ferry Terminal,Departure,2112,2172,1926,6210
4/30/2019,Q2,5,E,Harbour Control,Arrival,6,0,92,98
4/30/2019,Q2,5,E,Harbour Control,Departure,1,0,14,15
4/30/2019,Q2,5,E,Kai Tak Cruise Terminal,Arrival,658,292,45,995
4/30/2019,Q2,5,E,Kai Tak Cruise Terminal,Departure,868,195,41,1104
4/30/2019,Q2,5,E,Macau Ferry Terminal,Arrival,9674,1874,5052,16600
4/30/2019,Q2,5,E,Macau Ferry Terminal,Departure,9539,1979,4449,15967
4/30/2019,Q2,5,E,Tuen Mun Ferry Terminal,Arrival,675,19,27,721
4/30/2019,Q2,5,E,Tuen Mun Ferry Terminal,Departure,597,6,20,623
5/1/2019,Q2,5,E,Airport,Arrival,35782,20271,28085,84138
5/1/2019,Q2,5,E,Airport,Departure,31266,20266,27935,79467
5/1/2019,Q2,5,E,Express Rail Link West Kowloon,Arrival,6887,47187,1720,55794
5/1/2019,Q2,5,E,Express Rail Link West Kowloon,Departure,5201,21496,1604,28301
5/1/2019,Q2,5,E,Hung Hom,Arrival,1683,3407,491,5581
5/1/2019,Q2,5,E,Hung Hom,Departure,1367,1542,502,3411
5/1/2019,Q2,5,E,Lo Wu,Arrival,84407,59994,1923,146324
5/1/2019,Q2,5,E,Lo Wu,Departure,70630,53777,1884,126291
5/1/2019,Q2,5,E,Lok Ma Chau Spur Line,Arrival,44831,56860,979,102670
5/1/2019,Q2,5,E,Lok Ma Chau Spur Line,Departure,39410,41499,678,81587
5/1/2019,Q2,5,E,Hong Kong-Zhuhai-Macao Bridge,Arrival,16878,17781,3724,38383
5/1/2019,Q2,5,E,Hong Kong-Zhuhai-Macao Bridge,Departure,15229,19389,4254,38872
5/1/2019,Q2,5,E,Lok Ma Chau,Arrival,26941,19661,1263,47865
5/1/2019,Q2,5,E,Lok Ma Chau,Departure,19443,10858,691,30992
5/1/2019,Q2,5,E,Man Kam To,Arrival,1525,5089,66,6680
5/1/2019,Q2,5,E,Man Kam To,Departure,1351,2575,18,3944
5/1/2019,Q2,5,E,Sha Tau Kok,Arrival,1952,2548,152,4652
5/1/2019,Q2,5,E,Sha Tau Kok,Departure,1735,1458,71,3264
5/1/2019,Q2,5,E,Shenzhen Bay,Arrival,27065,48123,2302,77490
5/1/2019,Q2,5,E,Shenzhen Bay,Departure,21906,31125,1355,54386
5/1/2019,Q2,5,E,China Ferry Terminal,Arrival,1871,3804,1665,7340
5/1/2019,Q2,5,E,China Ferry Terminal,Departure,1409,3009,1718,6136
5/1/2019,Q2,5,E,Harbour Control,Arrival,6,0,39,45
5/1/2019,Q2,5,E,Harbour Control,Departure,0,0,0,0
5/1/2019,Q2,5,E,Kai Tak Cruise Terminal,Arrival,869,196,35,1100
5/1/2019,Q2,5,E,Kai Tak Cruise Terminal,Departure,654,670,27,1351
5/1/2019,Q2,5,E,Macau Ferry Terminal,Arrival,9358,2874,4473,16705
5/1/2019,Q2,5,E,Macau Ferry Terminal,Departure,6895,2642,3823,13360
5/1/2019,Q2,5,E,Tuen Mun Ferry Terminal,Arrival,594,37,44,675
5/1/2019,Q2,5,E,Tuen Mun Ferry Terminal,Departure,532,33,28,593
5/2/2019,Q2,5,E,Airport,Arrival,25793,18458,27307,71558
5/2/2019,Q2,5,E,Airport,Departure,24758,12761,24278,61797
5/2/2019,Q2,5,E,Express Rail Link West Kowloon,Arrival,4837,38710,1607,45154
5/2/2019,Q2,5,E,Express Rail Link West Kowloon,Departure,4512,28114,1109,33735
5/2/2019,Q2,5,E,Hung Hom,Arrival,1337,2389,492,4218
5/2/2019,Q2,5,E,Hung Hom,Departure,1543,2240,376,4159
5/2/2019,Q2,5,E,Lo Wu,Arrival,69115,64926,2174,136215
5/2/2019,Q2,5,E,Lo Wu,Departure,68197,80712,2302,151211
5/2/2019,Q2,5,E,Lok Ma Chau Spur Line,Arrival,42030,68084,1026,111140
5/2/2019,Q2,5,E,Lok Ma Chau Spur Line,Departure,41445,63463,939,105847
5/2/2019,Q2,5,E,Hong Kong-Zhuhai-Macao Bridge,Arrival,8733,23286,2933,34952
5/2/2019,Q2,5,E,Hong Kong-Zhuhai-Macao Bridge,Departure,8586,28437,3153,40176
5/2/2019,Q2,5,E,Lok Ma Chau,Arrival,21332,16720,966,39018
5/2/2019,Q2,5,E,Lok Ma Chau,Departure,18559,16763,932,36254
5/2/2019,Q2,5,E,Man Kam To,Arrival,3542,5552,51,9145
5/2/2019,Q2,5,E,Man Kam To,Departure,3703,3583,69,7355
5/2/2019,Q2,5,E,Sha Tau Kok,Arrival,2403,2658,118,5179
5/2/2019,Q2,5,E,Sha Tau Kok,Departure,2465,1946,96,4507
5/2/2019,Q2,5,E,Shenzhen Bay,Arrival,24279,50809,1976,77064
5/2/2019,Q2,5,E,Shenzhen Bay,Departure,23619,48160,1620,73399
5/2/2019,Q2,5,E,China Ferry Terminal,Arrival,1552,3873,1652,7077
5/2/2019,Q2,5,E,China Ferry Terminal,Departure,1699,4481,1910,8090
5/2/2019,Q2,5,E,Harbour Control,Arrival,1,0,52,53
5/2/2019,Q2,5,E,Harbour Control,Departure,3,0,35,38
5/2/2019,Q2,5,E,Kai Tak Cruise Terminal,Arrival,653,670,34,1357
5/2/2019,Q2,5,E,Kai Tak Cruise Terminal,Departure,549,687,43,1279
5/2/2019,Q2,5,E,Macau Ferry Terminal,Arrival,7306,3958,4947,16211
5/2/2019,Q2,5,E,Macau Ferry Terminal,Departure,7231,4316,4689,16236
5/2/2019,Q2,5,E,Tuen Mun Ferry Terminal,Arrival,426,52,29,507
5/2/2019,Q2,5,E,Tuen Mun Ferry Terminal,Departure,537,42,37,616
5/3/2019,Q2,5,E,Airport,Arrival,21716,19456,27771,68943
5/3/2019,Q2,5,E,Airport,Departure,27917,15539,26252,69708
5/3/2019,Q2,5,E,Express Rail Link West Kowloon,Arrival,4740,35174,1793,41707
5/3/2019,Q2,5,E,Express Rail Link West Kowloon,Departure,5741,35264,1056,42061
5/3/2019,Q2,5,E,Hung Hom,Arrival,1639,2260,698,4597
5/3/2019,Q2,5,E,Hung Hom,Departure,1823,2868,372,5063
5/3/2019,Q2,5,E,Lo Wu,Arrival,69250,50563,1987,121800
5/3/2019,Q2,5,E,Lo Wu,Departure,78735,71630,2360,152725
5/3/2019,Q2,5,E,Lok Ma Chau Spur Line,Arrival,41399,54949,908,97256
5/3/2019,Q2,5,E,Lok Ma Chau Spur Line,Departure,46938,60150,1003,108091
5/3/2019,Q2,5,E,Hong Kong-Zhuhai-Macao Bridge,Arrival,9021,18567,3481,31069
5/3/2019,Q2,5,E,Hong Kong-Zhuhai-Macao Bridge,Departure,10719,23441,3620,37780
5/3/2019,Q2,5,E,Lok Ma Chau,Arrival,20105,11909,896,32910
5/3/2019,Q2,5,E,Lok Ma Chau,Departure,21927,20243,935,43105
5/3/2019,Q2,5,E,Man Kam To,Arrival,3604,5144,35,8783
5/3/2019,Q2,5,E,Man Kam To,Departure,3787,3606,83,7476
5/3/2019,Q2,5,E,Sha Tau Kok,Arrival,2515,2418,125,5058
5/3/2019,Q2,5,E,Sha Tau Kok,Departure,2724,1980,113,4817
5/3/2019,Q2,5,E,Shenzhen Bay,Arrival,24439,41360,1929,67728
5/3/2019,Q2,5,E,Shenzhen Bay,Departure,28730,52698,1755,83183
5/3/2019,Q2,5,E,China Ferry Terminal,Arrival,1810,3500,1804,7114
5/3/2019,Q2,5,E,China Ferry Terminal,Departure,2041,4627,2192,8860
5/3/2019,Q2,5,E,Harbour Control,Arrival,11,0,93,104
5/3/2019,Q2,5,E,Harbour Control,Departure,2,5,21,28
5/3/2019,Q2,5,E,Kai Tak Cruise Terminal,Arrival,967,2628,271,3866
5/3/2019,Q2,5,E,Kai Tak Cruise Terminal,Departure,2959,1379,477,4815
5/3/2019,Q2,5,E,Macau Ferry Terminal,Arrival,7928,3818,5882,17628
5/3/2019,Q2,5,E,Macau Ferry Terminal,Departure,8538,3830,4880,17248
5/3/2019,Q2,5,E,Tuen Mun Ferry Terminal,Arrival,431,81,43,555
5/3/2019,Q2,5,E,Tuen Mun Ferry Terminal,Departure,510,61,27,598
5/4/2019,Q2,5,E,Airport,Arrival,23936,27260,25096,76292
5/4/2019,Q2,5,E,Airport,Departure,25189,19613,28495,73297
5/4/2019,Q2,5,E,Express Rail Link West Kowloon,Arrival,4192,18881,1319,24392
5/4/2019,Q2,5,E,Express Rail Link West Kowloon,Departure,7542,38495,1195,47232
5/4/2019,Q2,5,E,Hung Hom,Arrival,1344,1186,550,3080
5/4/2019,Q2,5,E,Hung Hom,Departure,1942,3062,430,5434
5/4/2019,Q2,5,E,Lo Wu,Arrival,74296,28924,1939,105159
5/4/2019,Q2,5,E,Lo Wu,Departure,95441,45200,2051,142692
5/4/2019,Q2,5,E,Lok Ma Chau Spur Line,Arrival,40692,31577,633,72902
5/4/2019,Q2,5,E,Lok Ma Chau Spur Line,Departure,53223,38681,821,92725
5/4/2019,Q2,5,E,Hong Kong-Zhuhai-Macao Bridge,Arrival,11631,8534,4835,25000
5/4/2019,Q2,5,E,Hong Kong-Zhuhai-Macao Bridge,Departure,17603,12466,4663,34732
5/4/2019,Q2,5,E,Lok Ma Chau,Arrival,21940,6855,693,29488
5/4/2019,Q2,5,E,Lok Ma Chau,Departure,25398,17703,975,44076
5/4/2019,Q2,5,E,Man Kam To,Arrival,2007,3767,33,5807
5/4/2019,Q2,5,E,Man Kam To,Departure,2700,3360,65,6125
5/4/2019,Q2,5,E,Sha Tau Kok,Arrival,2027,1301,79,3407
5/4/2019,Q2,5,E,Sha Tau Kok,Departure,2501,1699,121,4321
5/4/2019,Q2,5,E,Shenzhen Bay,Arrival,22743,25627,1464,49834
5/4/2019,Q2,5,E,Shenzhen Bay,Departure,32048,43429,2010,77487
5/4/2019,Q2,5,E,China Ferry Terminal,Arrival,1723,1683,1977,5383
5/4/2019,Q2,5,E,China Ferry Terminal,Departure,2574,2881,2170,7625
5/4/2019,Q2,5,E,Harbour Control,Arrival,0,0,43,43
5/4/2019,Q2,5,E,Harbour Control,Departure,0,0,11,11
5/4/2019,Q2,5,E,Kai Tak Cruise Terminal,Arrival,720,371,21,1112
5/4/2019,Q2,5,E,Kai Tak Cruise Terminal,Departure,839,173,19,1031
5/4/2019,Q2,5,E,Macau Ferry Terminal,Arrival,8378,1864,6218,16460
5/4/2019,Q2,5,E,Macau Ferry Terminal,Departure,12059,1947,5189,19195
5/4/2019,Q2,5,E,Tuen Mun Ferry Terminal,Arrival,511,29,47,587
5/4/2019,Q2,5,E,Tuen Mun Ferry Terminal,Departure,723,23,38,784
5/5/2019,Q2,5,E,Airport,Arrival,34679,24310,23717,82706
5/5/2019,Q2,5,E,Airport,Departure,26117,15943,33975,76035
5/5/2019,Q2,5,E,Express Rail Link West Kowloon,Arrival,8229,11538,1304,21071
5/5/2019,Q2,5,E,Express Rail Link West Kowloon,Departure,5337,14835,1357,21529
5/5/2019,Q2,5,E,Hung Hom,Arrival,1955,1043,396,3394
5/5/2019,Q2,5,E,Hung Hom,Departure,1048,1170,356,2574
5/5/2019,Q2,5,E,Lo Wu,Arrival,94880,22753,1818,119451
5/5/2019,Q2,5,E,Lo Wu,Departure,68572,24963,2035,95570
5/5/2019,Q2,5,E,Lok Ma Chau Spur Line,Arrival,48991,19687,547,69225
5/5/2019,Q2,5,E,Lok Ma Chau Spur Line,Departure,38724,19611,795,59130
5/5/2019,Q2,5,E,Hong Kong-Zhuhai-Macao Bridge,Arrival,16424,6665,3986,27075
5/5/2019,Q2,5,E,Hong Kong-Zhuhai-Macao Bridge,Departure,11207,8062,5010,24279
5/5/2019,Q2,5,E,Lok Ma Chau,Arrival,27906,6069,675,34650
5/5/2019,Q2,5,E,Lok Ma Chau,Departure,18564,13092,1587,33243
5/5/2019,Q2,5,E,Man Kam To,Arrival,1899,1571,124,3594
5/5/2019,Q2,5,E,Man Kam To,Departure,1407,1391,35,2833
5/5/2019,Q2,5,E,Sha Tau Kok,Arrival,2523,960,73,3556
5/5/2019,Q2,5,E,Sha Tau Kok,Departure,1678,825,127,2630
5/5/2019,Q2,5,E,Shenzhen Bay,Arrival,34813,16479,1286,52578
5/5/2019,Q2,5,E,Shenzhen Bay,Departure,22756,22776,2231,47763
5/5/2019,Q2,5,E,China Ferry Terminal,Arrival,2273,1199,1368,4840
5/5/2019,Q2,5,E,China Ferry Terminal,Departure,1424,1402,1915,4741
5/5/2019,Q2,5,E,Harbour Control,Arrival,137,0,45,182
5/5/2019,Q2,5,E,Harbour Control,Departure,0,0,1,1
5/5/2019,Q2,5,E,Kai Tak Cruise Terminal,Arrival,3078,1185,422,4685
5/5/2019,Q2,5,E,Kai Tak Cruise Terminal,Departure,959,911,248,2118
5/5/2019,Q2,5,E,Macau Ferry Terminal,Arrival,11381,1042,4632,17055
5/5/2019,Q2,5,E,Macau Ferry Terminal,Departure,6979,1043,5038,13060
5/5/2019,Q2,5,E,Tuen Mun Ferry Terminal,Arrival,684,12,24,720
5/5/2019,Q2,5,E,Tuen Mun Ferry Terminal,Departure,485,25,35,545
5/11/2019,Q2,5,F,Airport,Arrival,27788,13946,22122,63856
5/11/2019,Q2,5,F,Airport,Departure,48047,11291,21425,80763
5/11/2019,Q2,5,F,Express Rail Link West Kowloon,Arrival,5712,33050,1361,40123
5/11/2019,Q2,5,F,Express Rail Link West Kowloon,Departure,22668,24011,903,47582
5/11/2019,Q2,5,F,Hung Hom,Arrival,1056,2025,370,3451
5/11/2019,Q2,5,F,Hung Hom,Departure,3210,1800,242,5252
5/11/2019,Q2,5,F,Lo Wu,Arrival,80688,49995,2056,132739
5/11/2019,Q2,5,F,Lo Wu,Departure,138792,54384,1935,195111
5/11/2019,Q2,5,F,Lok Ma Chau Spur Line,Arrival,45228,54593,973,100794
5/11/2019,Q2,5,F,Lok Ma Chau Spur Line,Departure,72514,50181,874,123569
5/11/2019,Q2,5,F,Hong Kong-Zhuhai-Macao Bridge,Arrival,12431,15448,6448,34327
5/11/2019,Q2,5,F,Hong Kong-Zhuhai-Macao Bridge,Departure,29859,19660,5789,55308
5/11/2019,Q2,5,F,Lok Ma Chau,Arrival,24314,14386,1154,39854
5/11/2019,Q2,5,F,Lok Ma Chau,Departure,31585,14310,968,46863
5/11/2019,Q2,5,F,Man Kam To,Arrival,1903,5717,65,7685
5/11/2019,Q2,5,F,Man Kam To,Departure,3258,3303,49,6610
5/11/2019,Q2,5,F,Sha Tau Kok,Arrival,2014,2192,167,4373
5/11/2019,Q2,5,F,Sha Tau Kok,Departure,3737,1521,78,5336
5/11/2019,Q2,5,F,Shenzhen Bay,Arrival,25817,43006,2256,71079
5/11/2019,Q2,5,F,Shenzhen Bay,Departure,51941,41265,1734,94940
5/11/2019,Q2,5,F,China Ferry Terminal,Arrival,1716,2153,1482,5351
5/11/2019,Q2,5,F,China Ferry Terminal,Departure,4010,2442,1316,7768
5/11/2019,Q2,5,F,Harbour Control,Arrival,2,0,51,53
5/11/2019,Q2,5,F,Harbour Control,Departure,243,0,40,283
5/11/2019,Q2,5,F,Kai Tak Cruise Terminal,Arrival,625,209,28,862
5/11/2019,Q2,5,F,Kai Tak Cruise Terminal,Departure,788,299,21,1108
5/11/2019,Q2,5,F,Macau Ferry Terminal,Arrival,9128,1602,4963,15693
5/11/2019,Q2,5,F,Macau Ferry Terminal,Departure,14803,1637,4051,20491
5/11/2019,Q2,5,F,Tuen Mun Ferry Terminal,Arrival,496,9,46,551
5/11/2019,Q2,5,F,Tuen Mun Ferry Terminal,Departure,877,24,17,918
5/12/2019,Q2,5,F,Airport,Arrival,33832,12382,19602,65816
5/12/2019,Q2,5,F,Airport,Departure,37741,15363,26262,79366
5/12/2019,Q2,5,F,Express Rail Link West Kowloon,Arrival,8428,18914,1048,28390
5/12/2019,Q2,5,F,Express Rail Link West Kowloon,Departure,12988,27043,1470,41501
5/12/2019,Q2,5,F,Hung Hom,Arrival,1663,885,262,2810
5/12/2019,Q2,5,F,Hung Hom,Departure,1896,1830,349,4075
5/12/2019,Q2,5,F,Lo Wu,Arrival,104208,32653,1744,138605
5/12/2019,Q2,5,F,Lo Wu,Departure,113972,43301,2170,159443
5/12/2019,Q2,5,F,Lok Ma Chau Spur Line,Arrival,58086,39080,651,97817
5/12/2019,Q2,5,F,Lok Ma Chau Spur Line,Departure,69684,38986,869,109539
5/12/2019,Q2,5,F,Hong Kong-Zhuhai-Macao Bridge,Arrival,23318,12004,5273,40595
5/12/2019,Q2,5,F,Hong Kong-Zhuhai-Macao Bridge,Departure,35740,17541,6404,59685
5/12/2019,Q2,5,F,Lok Ma Chau,Arrival,31503,12733,690,44926
5/12/2019,Q2,5,F,Lok Ma Chau,Departure,26409,13636,1291,41336
5/12/2019,Q2,5,F,Man Kam To,Arrival,1853,3520,76,5449
5/12/2019,Q2,5,F,Man Kam To,Departure,1837,2380,42,4259
5/12/2019,Q2,5,F,Sha Tau Kok,Arrival,2511,1398,89,3998
5/12/2019,Q2,5,F,Sha Tau Kok,Departure,3070,1441,164,4675
5/12/2019,Q2,5,F,Shenzhen Bay,Arrival,39253,26712,1447,67412
5/12/2019,Q2,5,F,Shenzhen Bay,Departure,46049,32700,2355,81104
5/12/2019,Q2,5,F,China Ferry Terminal,Arrival,2605,1508,1179,5292
5/12/2019,Q2,5,F,China Ferry Terminal,Departure,4249,2114,1638,8001
5/12/2019,Q2,5,F,Harbour Control,Arrival,1,1,73,75
5/12/2019,Q2,5,F,Harbour Control,Departure,1,3,32,36
5/12/2019,Q2,5,F,Kai Tak Cruise Terminal,Arrival,788,299,16,1103
5/12/2019,Q2,5,F,Kai Tak Cruise Terminal,Departure,606,423,19,1048
5/12/2019,Q2,5,F,Macau Ferry Terminal,Arrival,12837,1405,3693,17935
5/12/2019,Q2,5,F,Macau Ferry Terminal,Departure,17411,1367,4235,23013
5/12/2019,Q2,5,F,Tuen Mun Ferry Terminal,Arrival,706,20,33,759
5/12/2019,Q2,5,F,Tuen Mun Ferry Terminal,Departure,1345,22,47,1414
5/13/2019,Q2,5,F,Airport,Arrival,57982,11824,19576,89382
5/13/2019,Q2,5,F,Airport,Departure,34117,12504,21855,68476
5/13/2019,Q2,5,F,Express Rail Link West Kowloon,Arrival,26014,12578,904,39496
5/13/2019,Q2,5,F,Express Rail Link West Kowloon,Departure,7068,11259,1023,19350
5/13/2019,Q2,5,F,Hung Hom,Arrival,3946,1269,221,5436
5/13/2019,Q2,5,F,Hung Hom,Departure,1567,906,266,2739
5/13/2019,Q2,5,F,Lo Wu,Arrival,164915,24930,1539,191384
5/13/2019,Q2,5,F,Lo Wu,Departure,92409,23377,1595,117381
5/13/2019,Q2,5,F,Lok Ma Chau Spur Line,Arrival,89393,20282,580,110255
5/13/2019,Q2,5,F,Lok Ma Chau Spur Line,Departure,58472,15957,594,75023
5/13/2019,Q2,5,F,Hong Kong-Zhuhai-Macao Bridge,Arrival,45565,9184,4580,59329
5/13/2019,Q2,5,F,Hong Kong-Zhuhai-Macao Bridge,Departure,19675,16100,5500,41275
5/13/2019,Q2,5,F,Lok Ma Chau,Arrival,41186,10190,669,52045
5/13/2019,Q2,5,F,Lok Ma Chau,Departure,23582,6896,1651,32129
5/13/2019,Q2,5,F,Man Kam To,Arrival,2821,2341,41,5203
5/13/2019,Q2,5,F,Man Kam To,Departure,1513,1219,30,2762
5/13/2019,Q2,5,F,Sha Tau Kok,Arrival,4132,983,64,5179
5/13/2019,Q2,5,F,Sha Tau Kok,Departure,2343,706,190,3239
5/13/2019,Q2,5,F,Shenzhen Bay,Arrival,71230,17434,1196,89860
5/13/2019,Q2,5,F,Shenzhen Bay,Departure,30648,16250,2102,49000
5/13/2019,Q2,5,F,China Ferry Terminal,Arrival,5928,1243,835,8006
5/13/2019,Q2,5,F,China Ferry Terminal,Departure,2301,1383,1296,4980
5/13/2019,Q2,5,F,Harbour Control,Arrival,1,0,50,51
5/13/2019,Q2,5,F,Harbour Control,Departure,0,0,0,0
5/13/2019,Q2,5,F,Kai Tak Cruise Terminal,Arrival,2883,735,271,3889
5/13/2019,Q2,5,F,Kai Tak Cruise Terminal,Departure,1141,339,94,1574
5/13/2019,Q2,5,F,Macau Ferry Terminal,Arrival,20573,1258,3036,24867
5/13/2019,Q2,5,F,Macau Ferry Terminal,Departure,9064,1193,3568,13825
5/13/2019,Q2,5,F,Tuen Mun Ferry Terminal,Arrival,1691,19,18,1728
5/13/2019,Q2,5,F,Tuen Mun Ferry Terminal,Departure,768,18,38,824
6/7/2019,Q2,5,G,Airport,Arrival,29192,16494,27712,73398
6/7/2019,Q2,5,G,Airport,Departure,44046,10497,21641,76184
6/7/2019,Q2,5,G,Express Rail Link West Kowloon,Arrival,6296,34660,1988,42944
6/7/2019,Q2,5,G,Express Rail Link West Kowloon,Departure,17585,18839,1135,37559
6/7/2019,Q2,5,G,Hung Hom,Arrival,1096,2152,423,3671
6/7/2019,Q2,5,G,Hung Hom,Departure,3073,1004,247,4324
6/7/2019,Q2,5,G,Lo Wu,Arrival,88261,40486,1994,130741
6/7/2019,Q2,5,G,Lo Wu,Departure,112966,39297,2226,154489
6/7/2019,Q2,5,G,Lok Ma Chau Spur Line,Arrival,49950,40601,972,91523
6/7/2019,Q2,5,G,Lok Ma Chau Spur Line,Departure,66871,32579,750,100200
6/7/2019,Q2,5,G,Hong Kong-Zhuhai-Macao Bridge,Arrival,18916,10580,6677,36173
6/7/2019,Q2,5,G,Hong Kong-Zhuhai-Macao Bridge,Departure,28581,11990,5788,46359
6/7/2019,Q2,5,G,Lok Ma Chau,Arrival,28208,10681,1261,40150
6/7/2019,Q2,5,G,Lok Ma Chau,Departure,28171,8303,837,37311
6/7/2019,Q2,5,G,Man Kam To,Arrival,1344,3420,156,4920
6/7/2019,Q2,5,G,Man Kam To,Departure,1977,2003,153,4133
6/7/2019,Q2,5,G,Sha Tau Kok,Arrival,1929,1590,170,3689
6/7/2019,Q2,5,G,Sha Tau Kok,Departure,3018,1061,71,4150
6/7/2019,Q2,5,G,Shenzhen Bay,Arrival,28622,33683,2212,64517
6/7/2019,Q2,5,G,Shenzhen Bay,Departure,46100,26397,1566,74063
6/7/2019,Q2,5,G,China Ferry Terminal,Arrival,1964,2346,2029,6339
6/7/2019,Q2,5,G,China Ferry Terminal,Departure,3618,2100,1714,7432
6/7/2019,Q2,5,G,Harbour Control,Arrival,1,0,81,82
6/7/2019,Q2,5,G,Harbour Control,Departure,0,0,7,7
6/7/2019,Q2,5,G,Kai Tak Cruise Terminal,Arrival,1317,1941,1107,4365
6/7/2019,Q2,5,G,Kai Tak Cruise Terminal,Departure,2460,1584,928,4972
6/7/2019,Q2,5,G,Macau Ferry Terminal,Arrival,11721,2052,5894,19667
6/7/2019,Q2,5,G,Macau Ferry Terminal,Departure,12697,1663,4586,18946
6/7/2019,Q2,5,G,Tuen Mun Ferry Terminal,Arrival,776,24,75,875
6/7/2019,Q2,5,G,Tuen Mun Ferry Terminal,Departure,838,22,34,894
6/8/2019,Q2,5,G,Airport,Arrival,36398,12210,22462,71070
6/8/2019,Q2,5,G,Airport,Departure,30589,11664,25156,67409
6/8/2019,Q2,5,G,Express Rail Link West Kowloon,Arrival,7510,30014,1335,38859
6/8/2019,Q2,5,G,Express Rail Link West Kowloon,Departure,7969,27914,1358,37241
6/8/2019,Q2,5,G,Hung Hom,Arrival,1624,1454,314,3392
6/8/2019,Q2,5,G,Hung Hom,Departure,1514,1874,363,3751
6/8/2019,Q2,5,G,Lo Wu,Arrival,89501,44205,1939,135645
6/8/2019,Q2,5,G,Lo Wu,Departure,94873,54844,2232,151949
6/8/2019,Q2,5,G,Lok Ma Chau Spur Line,Arrival,48825,50451,895,100171
6/8/2019,Q2,5,G,Lok Ma Chau Spur Line,Departure,53207,50221,992,104420
6/8/2019,Q2,5,G,Hong Kong-Zhuhai-Macao Bridge,Arrival,18264,12678,5466,36408
6/8/2019,Q2,5,G,Hong Kong-Zhuhai-Macao Bridge,Departure,18536,15056,5495,39087
6/8/2019,Q2,5,G,Lok Ma Chau,Arrival,26913,10124,823,37860
6/8/2019,Q2,5,G,Lok Ma Chau,Departure,24449,12253,933,37635
6/8/2019,Q2,5,G,Man Kam To,Arrival,1637,4174,157,5968
6/8/2019,Q2,5,G,Man Kam To,Departure,2052,3077,32,5161
6/8/2019,Q2,5,G,Sha Tau Kok,Arrival,2028,1754,102,3884
6/8/2019,Q2,5,G,Sha Tau Kok,Departure,2165,1494,111,3770
6/8/2019,Q2,5,G,Shenzhen Bay,Arrival,29193,37573,1534,68300
6/8/2019,Q2,5,G,Shenzhen Bay,Departure,30071,41554,1734,73359
6/8/2019,Q2,5,G,China Ferry Terminal,Arrival,2064,2301,1591,5956
6/8/2019,Q2,5,G,China Ferry Terminal,Departure,2206,3055,1825,7086
6/8/2019,Q2,5,G,Harbour Control,Arrival,1,0,73,74
6/8/2019,Q2,5,G,Harbour Control,Departure,1,0,6,7
6/8/2019,Q2,5,G,Kai Tak Cruise Terminal,Arrival,745,1569,128,2442
6/8/2019,Q2,5,G,Kai Tak Cruise Terminal,Departure,889,1605,119,2613
6/8/2019,Q2,5,G,Macau Ferry Terminal,Arrival,11788,2338,5827,19953
6/8/2019,Q2,5,G,Macau Ferry Terminal,Departure,11781,2377,5198,19356
6/8/2019,Q2,5,G,Tuen Mun Ferry Terminal,Arrival,700,35,88,823
6/8/2019,Q2,5,G,Tuen Mun Ferry Terminal,Departure,709,93,43,845
6/9/2019,Q2,5,G,Airport,Arrival,56811,14388,20219,91418
6/9/2019,Q2,5,G,Airport,Departure,30351,16966,34586,81903
6/9/2019,Q2,5,G,Express Rail Link West Kowloon,Arrival,18151,12846,997,31994
6/9/2019,Q2,5,G,Express Rail Link West Kowloon,Departure,5384,26734,1726,33844
6/9/2019,Q2,5,G,Hung Hom,Arrival,4334,937,219,5490
6/9/2019,Q2,5,G,Hung Hom,Departure,1189,2663,482,4334
6/9/2019,Q2,5,G,Lo Wu,Arrival,133493,26168,1603,161264
6/9/2019,Q2,5,G,Lo Wu,Departure,71579,36551,1964,110094
6/9/2019,Q2,5,G,Lok Ma Chau Spur Line,Arrival,61414,27217,624,89255
6/9/2019,Q2,5,G,Lok Ma Chau Spur Line,Departure,38295,30058,921,69274
6/9/2019,Q2,5,G,Hong Kong-Zhuhai-Macao Bridge,Arrival,30091,8834,4610,43535
6/9/2019,Q2,5,G,Hong Kong-Zhuhai-Macao Bridge,Departure,15058,10649,5850,31557
6/9/2019,Q2,5,G,Lok Ma Chau,Arrival,35606,7872,654,44132
6/9/2019,Q2,5,G,Lok Ma Chau,Departure,18553,11066,1335,30954
6/9/2019,Q2,5,G,Man Kam To,Arrival,2214,2542,142,4898
6/9/2019,Q2,5,G,Man Kam To,Departure,1257,2382,23,3662
6/9/2019,Q2,5,G,Sha Tau Kok,Arrival,3708,1106,60,4874
6/9/2019,Q2,5,G,Sha Tau Kok,Departure,1639,1205,170,3014
6/9/2019,Q2,5,G,Shenzhen Bay,Arrival,57738,21928,1438,81104
6/9/2019,Q2,5,G,Shenzhen Bay,Departure,24236,31655,2386,58277
6/9/2019,Q2,5,G,China Ferry Terminal,Arrival,4488,1359,1123,6970
6/9/2019,Q2,5,G,China Ferry Terminal,Departure,1641,2270,1756,5667
6/9/2019,Q2,5,G,Harbour Control,Arrival,1,0,115,116
6/9/2019,Q2,5,G,Harbour Control,Departure,1,0,10,11
6/9/2019,Q2,5,G,Kai Tak Cruise Terminal,Arrival,2610,1640,895,5145
6/9/2019,Q2,5,G,Kai Tak Cruise Terminal,Departure,1160,1615,326,3101
6/9/2019,Q2,5,G,Macau Ferry Terminal,Arrival,15046,1645,3689,20380
6/9/2019,Q2,5,G,Macau Ferry Terminal,Departure,8479,1542,4446,14467
6/9/2019,Q2,5,G,Tuen Mun Ferry Terminal,Arrival,945,26,41,1012
6/9/2019,Q2,5,G,Tuen Mun Ferry Terminal,Departure,727,29,95,851
6/29/2019,Q2,5,H,Airport,Arrival,37398,17109,23204,77711
6/29/2019,Q2,5,H,Airport,Departure,54954,11744,19899,86597
6/29/2019,Q2,5,H,Express Rail Link West Kowloon,Arrival,5896,24647,1307,31850
6/29/2019,Q2,5,H,Express Rail Link West Kowloon,Departure,25129,19847,1044,46020
6/29/2019,Q2,5,H,Hung Hom,Arrival,1100,1429,233,2762
6/29/2019,Q2,5,H,Hung Hom,Departure,3850,1249,186,5285
6/29/2019,Q2,5,H,Lo Wu,Arrival,79368,38601,1832,119801
6/29/2019,Q2,5,H,Lo Wu,Departure,140956,42719,1766,185441
6/29/2019,Q2,5,H,Lok Ma Chau Spur Line,Arrival,44766,43073,842,88681
6/29/2019,Q2,5,H,Lok Ma Chau Spur Line,Departure,75455,38917,704,115076
6/29/2019,Q2,5,H,Hong Kong-Zhuhai-Macao Bridge,Arrival,16249,9980,5057,31286
6/29/2019,Q2,5,H,Hong Kong-Zhuhai-Macao Bridge,Departure,38862,11506,4748,55116
6/29/2019,Q2,5,H,Lok Ma Chau,Arrival,23727,10811,1102,35640
6/29/2019,Q2,5,H,Lok Ma Chau,Departure,32631,11669,868,45168
6/29/2019,Q2,5,H,Man Kam To,Arrival,1475,3380,63,4918
6/29/2019,Q2,5,H,Man Kam To,Departure,2666,2786,75,5527
6/29/2019,Q2,5,H,Sha Tau Kok,Arrival,1749,1483,125,3357
6/29/2019,Q2,5,H,Sha Tau Kok,Departure,3554,1257,98,4909
6/29/2019,Q2,5,H,Shenzhen Bay,Arrival,23962,32500,1907,58369
6/29/2019,Q2,5,H,Shenzhen Bay,Departure,52505,31922,1307,85734
6/29/2019,Q2,5,H,China Ferry Terminal,Arrival,1916,1863,1235,5014
6/29/2019,Q2,5,H,China Ferry Terminal,Departure,5099,1953,1106,8158
6/29/2019,Q2,5,H,Harbour Control,Arrival,1,0,31,32
6/29/2019,Q2,5,H,Harbour Control,Departure,1,2,39,42
6/29/2019,Q2,5,H,Kai Tak Cruise Terminal,Arrival,753,304,22,1079
6/29/2019,Q2,5,H,Kai Tak Cruise Terminal,Departure,882,332,24,1238
6/29/2019,Q2,5,H,Macau Ferry Terminal,Arrival,10151,1586,4520,16257
6/29/2019,Q2,5,H,Macau Ferry Terminal,Departure,18238,1577,3837,23652
6/29/2019,Q2,5,H,Tuen Mun Ferry Terminal,Arrival,641,14,63,718
6/29/2019,Q2,5,H,Tuen Mun Ferry Terminal,Departure,1031,18,18,1067
6/30/2019,Q2,5,H,Airport,Arrival,43250,15320,18794,77364
6/30/2019,Q2,5,H,Airport,Departure,44710,15450,24963,85123
6/30/2019,Q2,5,H,Express Rail Link West Kowloon,Arrival,9293,15836,1040,26169
6/30/2019,Q2,5,H,Express Rail Link West Kowloon,Departure,14139,21053,1399,36591
6/30/2019,Q2,5,H,Hung Hom,Arrival,1942,1004,192,3138
6/30/2019,Q2,5,H,Hung Hom,Departure,1990,1559,290,3839
6/30/2019,Q2,5,H,Lo Wu,Arrival,104519,30487,1473,136479
6/30/2019,Q2,5,H,Lo Wu,Departure,122510,38672,1766,162948
6/30/2019,Q2,5,H,Lok Ma Chau Spur Line,Arrival,56305,36909,637,93851
6/30/2019,Q2,5,H,Lok Ma Chau Spur Line,Departure,72234,33436,780,106450
6/30/2019,Q2,5,H,Hong Kong-Zhuhai-Macao Bridge,Arrival,25146,8914,4251,38311
6/30/2019,Q2,5,H,Hong Kong-Zhuhai-Macao Bridge,Departure,40908,12381,5694,58983
6/30/2019,Q2,5,H,Lok Ma Chau,Arrival,31086,11799,755,43640
6/30/2019,Q2,5,H,Lok Ma Chau,Departure,28817,11139,1128,41084
6/30/2019,Q2,5,H,Man Kam To,Arrival,1436,3076,87,4599
6/30/2019,Q2,5,H,Man Kam To,Departure,1912,2158,37,4107
6/30/2019,Q2,5,H,Sha Tau Kok,Arrival,2085,1110,83,3278
6/30/2019,Q2,5,H,Sha Tau Kok,Departure,3114,1140,164,4418
6/30/2019,Q2,5,H,Shenzhen Bay,Arrival,37002,24255,1374,62631
6/30/2019,Q2,5,H,Shenzhen Bay,Departure,47803,29107,1759,78669
6/30/2019,Q2,5,H,China Ferry Terminal,Arrival,2843,1210,1101,5154
6/30/2019,Q2,5,H,China Ferry Terminal,Departure,4616,2008,1361,7985
6/30/2019,Q2,5,H,Harbour Control,Arrival,1,0,98,99
6/30/2019,Q2,5,H,Harbour Control,Departure,1,0,1,2
6/30/2019,Q2,5,H,Kai Tak Cruise Terminal,Arrival,4027,730,369,5126
6/30/2019,Q2,5,H,Kai Tak Cruise Terminal,Departure,2913,1396,165,4474
6/30/2019,Q2,5,H,Macau Ferry Terminal,Arrival,14749,1305,3044,19098
6/30/2019,Q2,5,H,Macau Ferry Terminal,Departure,18677,1500,3964,24141
6/30/2019,Q2,5,H,Tuen Mun Ferry Terminal,Arrival,940,26,18,984
6/30/2019,Q2,5,H,Tuen Mun Ferry Terminal,Departure,1382,18,34,1434
7/1/2019,Q3,5,H,Airport,Arrival,59866,12074,16728,88668
7/1/2019,Q3,5,H,Airport,Departure,37017,11836,22266,71119
7/1/2019,Q3,5,H,Express Rail Link West Kowloon,Arrival,27103,10817,870,38790
7/1/2019,Q3,5,H,Express Rail Link West Kowloon,Departure,6065,9425,786,16276
7/1/2019,Q3,5,H,Hung Hom,Arrival,4419,741,173,5333
7/1/2019,Q3,5,H,Hung Hom,Departure,1033,607,180,1820
7/1/2019,Q3,5,H,Lo Wu,Arrival,162571,22043,1562,186176
7/1/2019,Q3,5,H,Lo Wu,Departure,75924,20236,1397,97557
7/1/2019,Q3,5,H,Lok Ma Chau Spur Line,Arrival,89138,18069,592,107799
7/1/2019,Q3,5,H,Lok Ma Chau Spur Line,Departure,45686,13617,528,59831
7/1/2019,Q3,5,H,Hong Kong-Zhuhai-Macao Bridge,Arrival,50790,7190,3059,61039
7/1/2019,Q3,5,H,Hong Kong-Zhuhai-Macao Bridge,Departure,15679,17404,3115,36198
7/1/2019,Q3,5,H,Lok Ma Chau,Arrival,43738,7718,735,52191
7/1/2019,Q3,5,H,Lok Ma Chau,Departure,19583,6091,974,26648
7/1/2019,Q3,5,H,Man Kam To,Arrival,2452,1712,25,4189
7/1/2019,Q3,5,H,Man Kam To,Departure,1299,1158,41,2498
7/1/2019,Q3,5,H,Sha Tau Kok,Arrival,4276,817,102,5195
7/1/2019,Q3,5,H,Sha Tau Kok,Departure,1948,626,101,2675
7/1/2019,Q3,5,H,Shenzhen Bay,Arrival,74568,13825,1327,89720
7/1/2019,Q3,5,H,Shenzhen Bay,Departure,24419,12909,1657,38985
7/1/2019,Q3,5,H,China Ferry Terminal,Arrival,6540,884,643,8067
7/1/2019,Q3,5,H,China Ferry Terminal,Departure,2099,1383,1166,4648
7/1/2019,Q3,5,H,Harbour Control,Arrival,34,2,52,88
7/1/2019,Q3,5,H,Harbour Control,Departure,0,0,0,0
7/1/2019,Q3,5,H,Kai Tak Cruise Terminal,Arrival,892,312,23,1227
7/1/2019,Q3,5,H,Kai Tak Cruise Terminal,Departure,752,268,23,1043
7/1/2019,Q3,5,H,Macau Ferry Terminal,Arrival,23564,1346,2430,27340
7/1/2019,Q3,5,H,Macau Ferry Terminal,Departure,7348,1090,2423,10861
7/1/2019,Q3,5,H,Tuen Mun Ferry Terminal,Arrival,1757,15,14,1786
7/1/2019,Q3,5,H,Tuen Mun Ferry Terminal,Departure,709,11,28,748
9/12/2019,Q3,5,I,Airport,Arrival,30117,7169,15287,52573
9/12/2019,Q3,5,I,Airport,Departure,31514,7130,13718,52362
9/12/2019,Q3,5,I,Express Rail Link West Kowloon,Arrival,7361,6441,1131,14933
9/12/2019,Q3,5,I,Express Rail Link West Kowloon,Departure,10195,6220,554,16969
9/12/2019,Q3,5,I,Hung Hom,Arrival,2244,622,257,3123
9/12/2019,Q3,5,I,Hung Hom,Departure,1564,798,126,2488
9/12/2019,Q3,5,I,Lo Wu,Arrival,74067,18763,1210,94040
9/12/2019,Q3,5,I,Lo Wu,Departure,88787,20792,946,110525
9/12/2019,Q3,5,I,Lok Ma Chau Spur Line,Arrival,47575,16520,669,64764
9/12/2019,Q3,5,I,Lok Ma Chau Spur Line,Departure,46598,14636,381,61615
9/12/2019,Q3,5,I,Hong Kong-Zhuhai-Macao Bridge,Arrival,9900,1941,1711,13552
9/12/2019,Q3,5,I,Hong Kong-Zhuhai-Macao Bridge,Departure,11652,2516,2306,16474
9/12/2019,Q3,5,I,Lok Ma Chau,Arrival,22861,5071,1554,29486
9/12/2019,Q3,5,I,Lok Ma Chau,Departure,20643,5568,620,26831
9/12/2019,Q3,5,I,Man Kam To,Arrival,3930,1317,26,5273
9/12/2019,Q3,5,I,Man Kam To,Departure,3998,1010,15,5023
9/12/2019,Q3,5,I,Sha Tau Kok,Arrival,3065,741,157,3963
9/12/2019,Q3,5,I,Sha Tau Kok,Departure,3286,575,41,3902
9/12/2019,Q3,5,I,Shenzhen Bay,Arrival,30227,13261,2112,45600
9/12/2019,Q3,5,I,Shenzhen Bay,Departure,33385,13932,941,48258
9/12/2019,Q3,5,I,China Ferry Terminal,Arrival,2234,522,694,3450
9/12/2019,Q3,5,I,China Ferry Terminal,Departure,2127,735,638,3500
9/12/2019,Q3,5,I,Harbour Control,Arrival,13,0,48,61
9/12/2019,Q3,5,I,Harbour Control,Departure,37,2,18,57
9/12/2019,Q3,5,I,Kai Tak Cruise Terminal,Arrival,903,120,10,1033
9/12/2019,Q3,5,I,Kai Tak Cruise Terminal,Departure,564,72,9,645
9/12/2019,Q3,5,I,Macau Ferry Terminal,Arrival,8042,473,2204,10719
9/12/2019,Q3,5,I,Macau Ferry Terminal,Departure,7936,558,2350,10844
9/12/2019,Q3,5,I,Tuen Mun Ferry Terminal,Arrival,542,5,19,566
9/12/2019,Q3,5,I,Tuen Mun Ferry Terminal,Departure,474,2,16,492
9/13/2019,Q3,5,I,Airport,Arrival,23125,6705,14182,44012
9/13/2019,Q3,5,I,Airport,Departure,35807,4900,12628,53335
9/13/2019,Q3,5,I,Express Rail Link West Kowloon,Arrival,4324,8879,1148,14351
9/13/2019,Q3,5,I,Express Rail Link West Kowloon,Departure,17747,6076,635,24458
9/13/2019,Q3,5,I,Hung Hom,Arrival,655,543,198,1396
9/13/2019,Q3,5,I,Hung Hom,Departure,2782,400,140,3322
9/13/2019,Q3,5,I,Lo Wu,Arrival,55662,19000,1270,75932
9/13/2019,Q3,5,I,Lo Wu,Departure,114682,18488,1285,134455
9/13/2019,Q3,5,I,Lok Ma Chau Spur Line,Arrival,35577,19140,669,55386
9/13/2019,Q3,5,I,Lok Ma Chau Spur Line,Departure,54467,16446,442,71355
9/13/2019,Q3,5,I,Hong Kong-Zhuhai-Macao Bridge,Arrival,8726,2455,2384,13565
9/13/2019,Q3,5,I,Hong Kong-Zhuhai-Macao Bridge,Departure,20119,3057,2104,25280
9/13/2019,Q3,5,I,Lok Ma Chau,Arrival,18523,5114,902,24539
9/13/2019,Q3,5,I,Lok Ma Chau,Departure,24953,4765,483,30201
9/13/2019,Q3,5,I,Man Kam To,Arrival,2987,1227,19,4233
9/13/2019,Q3,5,I,Man Kam To,Departure,4107,938,69,5114
9/13/2019,Q3,5,I,Sha Tau Kok,Arrival,1919,683,103,2705
9/13/2019,Q3,5,I,Sha Tau Kok,Departure,3911,532,42,4485
9/13/2019,Q3,5,I,Shenzhen Bay,Arrival,20556,15762,1850,38168
9/13/2019,Q3,5,I,Shenzhen Bay,Departure,43265,13519,1074,57858
9/13/2019,Q3,5,I,China Ferry Terminal,Arrival,1365,747,864,2976
9/13/2019,Q3,5,I,China Ferry Terminal,Departure,3329,697,918,4944
9/13/2019,Q3,5,I,Harbour Control,Arrival,1,0,71,72
9/13/2019,Q3,5,I,Harbour Control,Departure,0,0,27,27
9/13/2019,Q3,5,I,Kai Tak Cruise Terminal,Arrival,1045,869,249,2163
9/13/2019,Q3,5,I,Kai Tak Cruise Terminal,Departure,3098,1254,275,4627
9/13/2019,Q3,5,I,Macau Ferry Terminal,Arrival,7501,580,2792,10873
9/13/2019,Q3,5,I,Macau Ferry Terminal,Departure,11006,599,2085,13690
9/13/2019,Q3,5,I,Tuen Mun Ferry Terminal,Arrival,489,3,41,533
9/13/2019,Q3,5,I,Tuen Mun Ferry Terminal,Departure,541,13,12,566
9/14/2019,Q3,5,I,Airport,Arrival,20395,4664,12938,37997
9/14/2019,Q3,5,I,Airport,Departure,32003,4499,11644,48146
9/14/2019,Q3,5,I,Express Rail Link West Kowloon,Arrival,6093,6659,696,13448
9/14/2019,Q3,5,I,Express Rail Link West Kowloon,Departure,11136,6869,779,18784
9/14/2019,Q3,5,I,Hung Hom,Arrival,849,449,132,1430
9/14/2019,Q3,5,I,Hung Hom,Departure,1888,424,129,2441
9/14/2019,Q3,5,I,Lo Wu,Arrival,82793,18511,1075,102379
9/14/2019,Q3,5,I,Lo Wu,Departure,110124,22267,1259,133650
9/14/2019,Q3,5,I,Lok Ma Chau Spur Line,Arrival,40079,20981,457,61517
9/14/2019,Q3,5,I,Lok Ma Chau Spur Line,Departure,55090,20993,507,76590
9/14/2019,Q3,5,I,Hong Kong-Zhuhai-Macao Bridge,Arrival,18388,2944,3922,25254
9/14/2019,Q3,5,I,Hong Kong-Zhuhai-Macao Bridge,Departure,29495,3329,3080,35904
9/14/2019,Q3,5,I,Lok Ma Chau,Arrival,19686,3922,382,23990
9/14/2019,Q3,5,I,Lok Ma Chau,Departure,25358,4722,555,30635
9/14/2019,Q3,5,I,Man Kam To,Arrival,1371,1544,19,2934
9/14/2019,Q3,5,I,Man Kam To,Departure,1740,1130,100,2970
9/14/2019,Q3,5,I,Sha Tau Kok,Arrival,2135,697,37,2869
9/14/2019,Q3,5,I,Sha Tau Kok,Departure,3081,589,60,3730
9/14/2019,Q3,5,I,Shenzhen Bay,Arrival,25073,16494,919,42486
9/14/2019,Q3,5,I,Shenzhen Bay,Departure,40035,17383,1297,58715
9/14/2019,Q3,5,I,China Ferry Terminal,Arrival,1971,646,886,3503
9/14/2019,Q3,5,I,China Ferry Terminal,Departure,3712,665,933,5310
9/14/2019,Q3,5,I,Harbour Control,Arrival,0,0,25,25
9/14/2019,Q3,5,I,Harbour Control,Departure,0,0,11,11
9/14/2019,Q3,5,I,Kai Tak Cruise Terminal,Arrival,649,78,63,790
9/14/2019,Q3,5,I,Kai Tak Cruise Terminal,Departure,956,91,5,1052
9/14/2019,Q3,5,I,Macau Ferry Terminal,Arrival,9021,664,2478,12163
9/14/2019,Q3,5,I,Macau Ferry Terminal,Departure,13641,660,2207,16508
9/14/2019,Q3,5,I,Tuen Mun Ferry Terminal,Arrival,835,16,54,905
9/14/2019,Q3,5,I,Tuen Mun Ferry Terminal,Departure,1009,17,28,1054
9/15/2019,Q3,5,I,Airport,Arrival,37821,8445,17401,63667
9/15/2019,Q3,5,I,Airport,Departure,30257,7053,15846,53156
9/15/2019,Q3,5,I,Express Rail Link West Kowloon,Arrival,17025,4631,562,22218
9/15/2019,Q3,5,I,Express Rail Link West Kowloon,Departure,5356,7468,1043,13867
9/15/2019,Q3,5,I,Hung Hom,Arrival,3384,393,127,3904
9/15/2019,Q3,5,I,Hung Hom,Departure,971,694,235,1900
9/15/2019,Q3,5,I,Lo Wu,Arrival,141696,19402,1009,162107
9/15/2019,Q3,5,I,Lo Wu,Departure,60168,21137,1301,82606
9/15/2019,Q3,5,I,Lok Ma Chau Spur Line,Arrival,62368,18438,383,81189
9/15/2019,Q3,5,I,Lok Ma Chau Spur Line,Departure,31919,18652,637,51208
9/15/2019,Q3,5,I,Hong Kong-Zhuhai-Macao Bridge,Arrival,33713,2627,2912,39252
9/15/2019,Q3,5,I,Hong Kong-Zhuhai-Macao Bridge,Departure,12222,3403,3691,19316
9/15/2019,Q3,5,I,Lok Ma Chau,Arrival,33071,4883,454,38408
9/15/2019,Q3,5,I,Lok Ma Chau,Departure,15026,5068,1237,21331
9/15/2019,Q3,5,I,Man Kam To,Arrival,2414,1389,25,3828
9/15/2019,Q3,5,I,Man Kam To,Departure,1135,1043,19,2197
9/15/2019,Q3,5,I,Sha Tau Kok,Arrival,4442,687,43,5172
9/15/2019,Q3,5,I,Sha Tau Kok,Departure,1458,631,119,2208
9/15/2019,Q3,5,I,Shenzhen Bay,Arrival,63214,13675,1144,78033
9/15/2019,Q3,5,I,Shenzhen Bay,Departure,19979,15990,1891,37860
9/15/2019,Q3,5,I,China Ferry Terminal,Arrival,5548,573,680,6801
9/15/2019,Q3,5,I,China Ferry Terminal,Departure,1504,779,906,3189
9/15/2019,Q3,5,I,Harbour Control,Arrival,0,2,46,48
9/15/2019,Q3,5,I,Harbour Control,Departure,2,0,1,3
9/15/2019,Q3,5,I,Kai Tak Cruise Terminal,Arrival,3406,1268,178,4852
9/15/2019,Q3,5,I,Kai Tak Cruise Terminal,Departure,917,858,351,2126
9/15/2019,Q3,5,I,Macau Ferry Terminal,Arrival,13771,535,1639,15945
9/15/2019,Q3,5,I,Macau Ferry Terminal,Departure,6845,435,1973,9253
9/15/2019,Q3,5,I,Tuen Mun Ferry Terminal,Arrival,1306,18,40,1364
9/15/2019,Q3,5,I,Tuen Mun Ferry Terminal,Departure,523,6,52,581
9/28/2019,Q3,5,J+K,Airport,Arrival,30377,8744,10799,49920
9/28/2019,Q3,5,J+K,Airport,Departure,41178,13316,15073,69567
9/28/2019,Q3,5,J+K,Express Rail Link West Kowloon,Arrival,5414,8995,1177,15586
9/28/2019,Q3,5,J+K,Express Rail Link West Kowloon,Departure,12377,8188,463,21028
9/28/2019,Q3,5,J+K,Hung Hom,Arrival,853,538,222,1613
9/28/2019,Q3,5,J+K,Hung Hom,Departure,1669,470,82,2221
9/28/2019,Q3,5,J+K,Lo Wu,Arrival,71895,23988,1350,97233
9/28/2019,Q3,5,J+K,Lo Wu,Departure,104733,27358,826,132917
9/28/2019,Q3,5,J+K,Lok Ma Chau Spur Line,Arrival,39403,28587,676,68666
9/28/2019,Q3,5,J+K,Lok Ma Chau Spur Line,Departure,53245,27211,389,80845
9/28/2019,Q3,5,J+K,Hong Kong-Zhuhai-Macao Bridge,Arrival,12556,2566,2871,17993
9/28/2019,Q3,5,J+K,Hong Kong-Zhuhai-Macao Bridge,Departure,22230,3724,2559,28513
9/28/2019,Q3,5,J+K,Lok Ma Chau,Arrival,20611,6296,1430,28337
9/28/2019,Q3,5,J+K,Lok Ma Chau,Departure,24997,6002,428,31427
9/28/2019,Q3,5,J+K,Man Kam To,Arrival,1656,2343,94,4093
9/28/2019,Q3,5,J+K,Man Kam To,Departure,2321,1613,46,3980
9/28/2019,Q3,5,J+K,Sha Tau Kok,Arrival,1835,981,203,3019
9/28/2019,Q3,5,J+K,Sha Tau Kok,Departure,2773,711,43,3527
9/28/2019,Q3,5,J+K,Shenzhen Bay,Arrival,22713,22119,2733,47565
9/28/2019,Q3,5,J+K,Shenzhen Bay,Departure,36725,20244,728,57697
9/28/2019,Q3,5,J+K,China Ferry Terminal,Arrival,1644,693,786,3123
9/28/2019,Q3,5,J+K,China Ferry Terminal,Departure,3626,748,619,4993
9/28/2019,Q3,5,J+K,Harbour Control,Arrival,1,0,35,36
9/28/2019,Q3,5,J+K,Harbour Control,Departure,2,0,29,31
9/28/2019,Q3,5,J+K,Kai Tak Cruise Terminal,Arrival,951,524,58,1533
9/28/2019,Q3,5,J+K,Kai Tak Cruise Terminal,Departure,983,394,34,1411
9/28/2019,Q3,5,J+K,Macau Ferry Terminal,Arrival,8497,504,2079,11080
9/28/2019,Q3,5,J+K,Macau Ferry Terminal,Departure,13343,554,1938,15835
9/28/2019,Q3,5,J+K,Tuen Mun Ferry Terminal,Arrival,619,10,25,654
9/28/2019,Q3,5,J+K,Tuen Mun Ferry Terminal,Departure,880,14,19,913
9/29/2019,Q3,5,J+K,Airport,Arrival,34954,7386,8907,51247
9/29/2019,Q3,5,J+K,Airport,Departure,27268,13238,16694,57200
9/29/2019,Q3,5,J+K,Express Rail Link West Kowloon,Arrival,9992,7110,999,18101
9/29/2019,Q3,5,J+K,Express Rail Link West Kowloon,Departure,6630,4999,398,12027
9/29/2019,Q3,5,J+K,Hung Hom,Arrival,1440,820,174,2434
9/29/2019,Q3,5,J+K,Hung Hom,Departure,772,360,90,1222
9/29/2019,Q3,5,J+K,Lo Wu,Arrival,95657,18237,1078,114972
9/29/2019,Q3,5,J+K,Lo Wu,Departure,73850,18287,765,92902
9/29/2019,Q3,5,J+K,Lok Ma Chau Spur Line,Arrival,51058,16268,526,67852
9/29/2019,Q3,5,J+K,Lok Ma Chau Spur Line,Departure,38219,13925,286,52430
9/29/2019,Q3,5,J+K,Hong Kong-Zhuhai-Macao Bridge,Arrival,22483,2501,2507,27491
9/29/2019,Q3,5,J+K,Hong Kong-Zhuhai-Macao Bridge,Departure,16987,2656,2947,22590
9/29/2019,Q3,5,J+K,Lok Ma Chau,Arrival,26914,6237,1387,34538
9/29/2019,Q3,5,J+K,Lok Ma Chau,Departure,17721,4519,329,22569
9/29/2019,Q3,5,J+K,Man Kam To,Arrival,1825,1273,73,3171
9/29/2019,Q3,5,J+K,Man Kam To,Departure,1423,844,12,2279
9/29/2019,Q3,5,J+K,Sha Tau Kok,Arrival,2864,726,137,3727
9/29/2019,Q3,5,J+K,Sha Tau Kok,Departure,2280,541,20,2841
9/29/2019,Q3,5,J+K,Shenzhen Bay,Arrival,40043,14973,2073,57089
9/29/2019,Q3,5,J+K,Shenzhen Bay,Departure,26864,11326,598,38788
9/29/2019,Q3,5,J+K,China Ferry Terminal,Arrival,3476,495,545,4516
9/29/2019,Q3,5,J+K,China Ferry Terminal,Departure,2290,649,473,3412
9/29/2019,Q3,5,J+K,Harbour Control,Arrival,0,0,104,104
9/29/2019,Q3,5,J+K,Harbour Control,Departure,0,0,1,1
9/29/2019,Q3,5,J+K,Kai Tak Cruise Terminal,Arrival,3072,554,360,3986
9/29/2019,Q3,5,J+K,Kai Tak Cruise Terminal,Departure,817,271,224,1312
9/29/2019,Q3,5,J+K,Macau Ferry Terminal,Arrival,12523,461,1582,14566
9/29/2019,Q3,5,J+K,Macau Ferry Terminal,Departure,9423,372,1589,11384
9/29/2019,Q3,5,J+K,Tuen Mun Ferry Terminal,Arrival,995,14,22,1031
9/29/2019,Q3,5,J+K,Tuen Mun Ferry Terminal,Departure,816,9,11,836
9/30/2019,Q3,5,J+K,Airport,Arrival,36897,9642,10027,56566
9/30/2019,Q3,5,J+K,Airport,Departure,22038,23249,14243,59530
9/30/2019,Q3,5,J+K,Express Rail Link West Kowloon,Arrival,7970,11375,1251,20596
9/30/2019,Q3,5,J+K,Express Rail Link West Kowloon,Departure,7288,5860,425,13573
9/30/2019,Q3,5,J+K,Hung Hom,Arrival,1467,876,293,2636
9/30/2019,Q3,5,J+K,Hung Hom,Departure,1127,471,149,1747
9/30/2019,Q3,5,J+K,Lo Wu,Arrival,74161,22699,1252,98112
9/30/2019,Q3,5,J+K,Lo Wu,Departure,83721,19538,776,104035
9/30/2019,Q3,5,J+K,Lok Ma Chau Spur Line,Arrival,44722,19699,662,65083
9/30/2019,Q3,5,J+K,Lok Ma Chau Spur Line,Departure,47125,16097,339,63561
9/30/2019,Q3,5,J+K,Hong Kong-Zhuhai-Macao Bridge,Arrival,14185,3721,1911,19817
9/30/2019,Q3,5,J+K,Hong Kong-Zhuhai-Macao Bridge,Departure,13936,2746,2024,18706
9/30/2019,Q3,5,J+K,Lok Ma Chau,Arrival,22601,10208,1485,34294
9/30/2019,Q3,5,J+K,Lok Ma Chau,Departure,21005,5503,374,26882
9/30/2019,Q3,5,J+K,Man Kam To,Arrival,3273,1789,55,5117
9/30/2019,Q3,5,J+K,Man Kam To,Departure,3649,1215,18,4882
9/30/2019,Q3,5,J+K,Sha Tau Kok,Arrival,2662,961,150,3773
9/30/2019,Q3,5,J+K,Sha Tau Kok,Departure,3004,590,65,3659
9/30/2019,Q3,5,J+K,Shenzhen Bay,Arrival,28068,21174,2188,51430
9/30/2019,Q3,5,J+K,Shenzhen Bay,Departure,28067,12279,728,41074
9/30/2019,Q3,5,J+K,China Ferry Terminal,Arrival,2481,1032,625,4138
9/30/2019,Q3,5,J+K,China Ferry Terminal,Departure,2066,894,410,3370
9/30/2019,Q3,5,J+K,Harbour Control,Arrival,1,0,52,53
9/30/2019,Q3,5,J+K,Harbour Control,Departure,1,5,34,40
9/30/2019,Q3,5,J+K,Kai Tak Cruise Terminal,Arrival,746,71,13,830
9/30/2019,Q3,5,J+K,Kai Tak Cruise Terminal,Departure,881,57,155,1093
9/30/2019,Q3,5,J+K,Macau Ferry Terminal,Arrival,10403,668,1862,12933
9/30/2019,Q3,5,J+K,Macau Ferry Terminal,Departure,10340,607,1674,12621
9/30/2019,Q3,5,J+K,Tuen Mun Ferry Terminal,Arrival,791,7,21,819
9/30/2019,Q3,5,J+K,Tuen Mun Ferry Terminal,Departure,579,10,15,604
10/1/2019,Q4,5,J+K,Airport,Arrival,43552,8315,8491,60358
10/1/2019,Q4,5,J+K,Airport,Departure,18262,25924,11451,55637
10/1/2019,Q4,5,J+K,Express Rail Link West Kowloon,Arrival,8901,14268,1132,24301
10/1/2019,Q4,5,J+K,Express Rail Link West Kowloon,Departure,4163,4066,337,8566
10/1/2019,Q4,5,J+K,Hung Hom,Arrival,994,792,190,1976
10/1/2019,Q4,5,J+K,Hung Hom,Departure,512,226,67,805
10/1/2019,Q4,5,J+K,Lo Wu,Arrival,58762,18018,922,77702
10/1/2019,Q4,5,J+K,Lo Wu,Departure,43804,12018,516,56338
10/1/2019,Q4,5,J+K,Lok Ma Chau Spur Line,Arrival,32958,14635,523,48116
10/1/2019,Q4,5,J+K,Lok Ma Chau Spur Line,Departure,24412,8420,212,33044
10/1/2019,Q4,5,J+K,Hong Kong-Zhuhai-Macao Bridge,Arrival,15153,4659,1513,21325
10/1/2019,Q4,5,J+K,Hong Kong-Zhuhai-Macao Bridge,Departure,9617,3305,1502,14424
10/1/2019,Q4,5,J+K,Lok Ma Chau,Arrival,20377,11156,1455,32988
10/1/2019,Q4,5,J+K,Lok Ma Chau,Departure,14011,4533,234,18778
10/1/2019,Q4,5,J+K,Man Kam To,Arrival,1336,1319,16,2671
10/1/2019,Q4,5,J+K,Man Kam To,Departure,1020,516,5,1541
10/1/2019,Q4,5,J+K,Sha Tau Kok,Arrival,1899,927,122,2948
10/1/2019,Q4,5,J+K,Sha Tau Kok,Departure,1341,331,20,1692
10/1/2019,Q4,5,J+K,Shenzhen Bay,Arrival,20016,17093,1880,38989
10/1/2019,Q4,5,J+K,Shenzhen Bay,Departure,13196,5180,357,18733
10/1/2019,Q4,5,J+K,China Ferry Terminal,Arrival,2581,1264,591,4436
10/1/2019,Q4,5,J+K,China Ferry Terminal,Departure,1089,755,479,2323
10/1/2019,Q4,5,J+K,Harbour Control,Arrival,0,2,52,54
10/1/2019,Q4,5,J+K,Harbour Control,Departure,0,0,2,2
10/1/2019,Q4,5,J+K,Kai Tak Cruise Terminal,Arrival,878,57,5,940
10/1/2019,Q4,5,J+K,Kai Tak Cruise Terminal,Departure,478,74,7,559
10/1/2019,Q4,5,J+K,Macau Ferry Terminal,Arrival,7192,574,1044,8810
10/1/2019,Q4,5,J+K,Macau Ferry Terminal,Departure,3625,541,878,5044
10/1/2019,Q4,5,J+K,Tuen Mun Ferry Terminal,Arrival,868,18,28,914
10/1/2019,Q4,5,J+K,Tuen Mun Ferry Terminal,Departure,419,15,15,449
10/2/2019,Q4,5,J+K,Airport,Arrival,33408,9835,12548,55791
10/2/2019,Q4,5,J+K,Airport,Departure,21346,16219,10210,47775
10/2/2019,Q4,5,J+K,Express Rail Link West Kowloon,Arrival,8382,18996,1097,28475
10/2/2019,Q4,5,J+K,Express Rail Link West Kowloon,Departure,4417,9348,545,14310
10/2/2019,Q4,5,J+K,Hung Hom,Arrival,1056,1264,263,2583
10/2/2019,Q4,5,J+K,Hung Hom,Departure,810,508,129,1447
10/2/2019,Q4,5,J+K,Lo Wu,Arrival,68924,27063,1066,97053
10/2/2019,Q4,5,J+K,Lo Wu,Departure,60010,25067,887,85964
10/2/2019,Q4,5,J+K,Lok Ma Chau Spur Line,Arrival,41903,25028,589,67520
10/2/2019,Q4,5,J+K,Lok Ma Chau Spur Line,Departure,36506,18875,383,55764
10/2/2019,Q4,5,J+K,Hong Kong-Zhuhai-Macao Bridge,Arrival,11738,6961,1932,20631
10/2/2019,Q4,5,J+K,Hong Kong-Zhuhai-Macao Bridge,Departure,9366,6846,2517,18729
10/2/2019,Q4,5,J+K,Lok Ma Chau,Arrival,20013,10512,750,31275
10/2/2019,Q4,5,J+K,Lok Ma Chau,Departure,14100,5208,380,19688
10/2/2019,Q4,5,J+K,Man Kam To,Arrival,3664,1765,25,5454
10/2/2019,Q4,5,J+K,Man Kam To,Departure,3553,1097,7,4657
10/2/2019,Q4,5,J+K,Sha Tau Kok,Arrival,2554,1093,82,3729
10/2/2019,Q4,5,J+K,Sha Tau Kok,Departure,2349,577,40,2966
10/2/2019,Q4,5,J+K,Shenzhen Bay,Arrival,25865,26784,1531,54180
10/2/2019,Q4,5,J+K,Shenzhen Bay,Departure,19986,17001,797,37784
10/2/2019,Q4,5,J+K,China Ferry Terminal,Arrival,1675,1708,507,3890
10/2/2019,Q4,5,J+K,China Ferry Terminal,Departure,1139,1332,455,2926
10/2/2019,Q4,5,J+K,Harbour Control,Arrival,1,0,64,65
10/2/2019,Q4,5,J+K,Harbour Control,Departure,1,0,19,20
10/2/2019,Q4,5,J+K,Kai Tak Cruise Terminal,Arrival,478,74,11,563
10/2/2019,Q4,5,J+K,Kai Tak Cruise Terminal,Departure,744,112,11,867
10/2/2019,Q4,5,J+K,Macau Ferry Terminal,Arrival,6972,1261,2041,10274
10/2/2019,Q4,5,J+K,Macau Ferry Terminal,Departure,6109,958,1802,8869
10/2/2019,Q4,5,J+K,Tuen Mun Ferry Terminal,Arrival,370,13,6,389
10/2/2019,Q4,5,J+K,Tuen Mun Ferry Terminal,Departure,407,16,18,441
10/3/2019,Q4,5,J+K,Airport,Arrival,23436,12830,15228,51494
10/3/2019,Q4,5,J+K,Airport,Departure,27518,9663,10216,47397
10/3/2019,Q4,5,J+K,Express Rail Link West Kowloon,Arrival,5545,15816,867,22228
10/3/2019,Q4,5,J+K,Express Rail Link West Kowloon,Departure,5563,14132,898,20593
10/3/2019,Q4,5,J+K,Hung Hom,Arrival,794,964,170,1928
10/3/2019,Q4,5,J+K,Hung Hom,Departure,818,1259,199,2276
10/3/2019,Q4,5,J+K,Lo Wu,Arrival,64032,27943,971,92946
10/3/2019,Q4,5,J+K,Lo Wu,Departure,66371,30334,1174,97879
10/3/2019,Q4,5,J+K,Lok Ma Chau Spur Line,Arrival,39361,25104,534,64999
10/3/2019,Q4,5,J+K,Lok Ma Chau Spur Line,Departure,39489,22654,623,62766
10/3/2019,Q4,5,J+K,Hong Kong-Zhuhai-Macao Bridge,Arrival,9788,7646,1391,18825
10/3/2019,Q4,5,J+K,Hong Kong-Zhuhai-Macao Bridge,Departure,9868,9010,1858,20736
10/3/2019,Q4,5,J+K,Lok Ma Chau,Arrival,17066,7989,494,25549
10/3/2019,Q4,5,J+K,Lok Ma Chau,Departure,15733,7485,682,23900
10/3/2019,Q4,5,J+K,Man Kam To,Arrival,3694,1989,32,5715
10/3/2019,Q4,5,J+K,Man Kam To,Departure,3619,1331,19,4969
10/3/2019,Q4,5,J+K,Sha Tau Kok,Arrival,2486,1024,71,3581
10/3/2019,Q4,5,J+K,Sha Tau Kok,Departure,2522,804,95,3421
10/3/2019,Q4,5,J+K,Shenzhen Bay,Arrival,23465,23155,1071,47691
10/3/2019,Q4,5,J+K,Shenzhen Bay,Departure,23675,22479,1455,47609
10/3/2019,Q4,5,J+K,China Ferry Terminal,Arrival,1577,1829,571,3977
10/3/2019,Q4,5,J+K,China Ferry Terminal,Departure,1531,2054,640,4225
10/3/2019,Q4,5,J+K,Harbour Control,Arrival,0,0,219,219
10/3/2019,Q4,5,J+K,Harbour Control,Departure,0,0,4,4
10/3/2019,Q4,5,J+K,Kai Tak Cruise Terminal,Arrival,753,116,499,1368
10/3/2019,Q4,5,J+K,Kai Tak Cruise Terminal,Departure,701,156,161,1018
10/3/2019,Q4,5,J+K,Macau Ferry Terminal,Arrival,6557,1349,1850,9756
10/3/2019,Q4,5,J+K,Macau Ferry Terminal,Departure,6986,1271,1845,10102
10/3/2019,Q4,5,J+K,Tuen Mun Ferry Terminal,Arrival,434,9,10,453
10/3/2019,Q4,5,J+K,Tuen Mun Ferry Terminal,Departure,524,8,8,540
10/4/2019,Q4,5,J+K,Airport,Arrival,23810,16666,14272,54748
10/4/2019,Q4,5,J+K,Airport,Departure,47974,7796,10211,65981
10/4/2019,Q4,5,J+K,Express Rail Link West Kowloon,Arrival,4604,14112,623,19339
10/4/2019,Q4,5,J+K,Express Rail Link West Kowloon,Departure,12854,16917,1114,30885
10/4/2019,Q4,5,J+K,Hung Hom,Arrival,703,1180,154,2037
10/4/2019,Q4,5,J+K,Hung Hom,Departure,1951,1271,246,3468
10/4/2019,Q4,5,J+K,Lo Wu,Arrival,60879,27228,909,89016
10/4/2019,Q4,5,J+K,Lo Wu,Departure,85453,30618,1197,117268
10/4/2019,Q4,5,J+K,Lok Ma Chau Spur Line,Arrival,38779,23642,446,62867
10/4/2019,Q4,5,J+K,Lok Ma Chau Spur Line,Departure,48599,24114,672,73385
10/4/2019,Q4,5,J+K,Hong Kong-Zhuhai-Macao Bridge,Arrival,9855,6884,1783,18522
10/4/2019,Q4,5,J+K,Hong Kong-Zhuhai-Macao Bridge,Departure,15135,9755,2045,26935
10/4/2019,Q4,5,J+K,Lok Ma Chau,Arrival,20442,6470,372,27284
10/4/2019,Q4,5,J+K,Lok Ma Chau,Departure,23579,9965,965,34509
10/4/2019,Q4,5,J+K,Man Kam To,Arrival,3564,2139,14,5717
10/4/2019,Q4,5,J+K,Man Kam To,Departure,3903,1553,69,5525
10/4/2019,Q4,5,J+K,Sha Tau Kok,Arrival,2556,958,38,3552
10/4/2019,Q4,5,J+K,Sha Tau Kok,Departure,3240,956,89,4285
10/4/2019,Q4,5,J+K,Shenzhen Bay,Arrival,22715,21703,833,45251
10/4/2019,Q4,5,J+K,Shenzhen Bay,Departure,34945,26553,1959,63457
10/4/2019,Q4,5,J+K,China Ferry Terminal,Arrival,1825,1941,699,4465
10/4/2019,Q4,5,J+K,China Ferry Terminal,Departure,2539,2383,800,5722
10/4/2019,Q4,5,J+K,Harbour Control,Arrival,1,0,83,84
10/4/2019,Q4,5,J+K,Harbour Control,Departure,1,0,41,42
10/4/2019,Q4,5,J+K,Kai Tak Cruise Terminal,Arrival,811,2201,73,3085
10/4/2019,Q4,5,J+K,Kai Tak Cruise Terminal,Departure,2341,2538,873,5752
10/4/2019,Q4,5,J+K,Macau Ferry Terminal,Arrival,6804,1312,2150,10266
10/4/2019,Q4,5,J+K,Macau Ferry Terminal,Departure,8460,1524,1968,11952
10/4/2019,Q4,5,J+K,Tuen Mun Ferry Terminal,Arrival,560,28,18,606
10/4/2019,Q4,5,J+K,Tuen Mun Ferry Terminal,Departure,502,17,10,529
10/5/2019,Q4,5,J+K,Airport,Arrival,24119,20943,13675,58737
10/5/2019,Q4,5,J+K,Airport,Departure,45474,8553,10611,64638
10/5/2019,Q4,5,J+K,Express Rail Link West Kowloon,Arrival,4268,6304,376,10948
10/5/2019,Q4,5,J+K,Express Rail Link West Kowloon,Departure,23739,17435,1092,42266
10/5/2019,Q4,5,J+K,Hung Hom,Arrival,2,0,0,2
10/5/2019,Q4,5,J+K,Hung Hom,Departure,0,0,0,0
10/5/2019,Q4,5,J+K,Lo Wu,Arrival,414,6,3,423
10/5/2019,Q4,5,J+K,Lo Wu,Departure,508,22,4,534
10/5/2019,Q4,5,J+K,Lok Ma Chau Spur Line,Arrival,16081,8667,279,25027
10/5/2019,Q4,5,J+K,Lok Ma Chau Spur Line,Departure,34622,10978,505,46105
10/5/2019,Q4,5,J+K,Hong Kong-Zhuhai-Macao Bridge,Arrival,9049,3939,1788,14776
10/5/2019,Q4,5,J+K,Hong Kong-Zhuhai-Macao Bridge,Departure,25787,8584,2014,36385
10/5/2019,Q4,5,J+K,Lok Ma Chau,Arrival,29629,6389,581,36599
10/5/2019,Q4,5,J+K,Lok Ma Chau,Departure,55967,19095,1709,76771
10/5/2019,Q4,5,J+K,Man Kam To,Arrival,5322,2166,91,7579
10/5/2019,Q4,5,J+K,Man Kam To,Departure,9629,3236,126,12991
10/5/2019,Q4,5,J+K,Sha Tau Kok,Arrival,1777,494,62,2333
10/5/2019,Q4,5,J+K,Sha Tau Kok,Departure,5323,1385,176,6884
10/5/2019,Q4,5,J+K,Shenzhen Bay,Arrival,18224,10341,620,29185
10/5/2019,Q4,5,J+K,Shenzhen Bay,Departure,59900,27746,2574,90220
10/5/2019,Q4,5,J+K,China Ferry Terminal,Arrival,1525,887,622,3034
10/5/2019,Q4,5,J+K,China Ferry Terminal,Departure,5189,2464,972,8625
10/5/2019,Q4,5,J+K,Harbour Control,Arrival,0,0,41,41
10/5/2019,Q4,5,J+K,Harbour Control,Departure,7,1,0,8
10/5/2019,Q4,5,J+K,Kai Tak Cruise Terminal,Arrival,744,172,6,922
10/5/2019,Q4,5,J+K,Kai Tak Cruise Terminal,Departure,803,78,2,883
10/5/2019,Q4,5,J+K,Macau Ferry Terminal,Arrival,5023,755,1600,7378
10/5/2019,Q4,5,J+K,Macau Ferry Terminal,Departure,11314,1359,1823,14496
10/5/2019,Q4,5,J+K,Tuen Mun Ferry Terminal,Arrival,449,11,35,495
10/5/2019,Q4,5,J+K,Tuen Mun Ferry Terminal,Departure,916,21,16,953
10/6/2019,Q4,5,J+K,Airport,Arrival,26678,28942,13253,68873
10/6/2019,Q4,5,J+K,Airport,Departure,33739,10036,12880,56655
10/6/2019,Q4,5,J+K,Express Rail Link West Kowloon,Arrival,6458,2677,357,9492
10/6/2019,Q4,5,J+K,Express Rail Link West Kowloon,Departure,10693,12223,1060,23976
10/6/2019,Q4,5,J+K,Hung Hom,Arrival,368,157,77,602
10/6/2019,Q4,5,J+K,Hung Hom,Departure,1414,387,147,1948
10/6/2019,Q4,5,J+K,Lo Wu,Arrival,30751,4637,404,35792
10/6/2019,Q4,5,J+K,Lo Wu,Departure,51284,7886,545,59715
10/6/2019,Q4,5,J+K,Lok Ma Chau Spur Line,Arrival,29918,8267,224,38409
10/6/2019,Q4,5,J+K,Lok Ma Chau Spur Line,Departure,42954,11328,626,54908
10/6/2019,Q4,5,J+K,Hong Kong-Zhuhai-Macao Bridge,Arrival,16665,2806,1898,21369
10/6/2019,Q4,5,J+K,Hong Kong-Zhuhai-Macao Bridge,Departure,23811,5391,2210,31412
10/6/2019,Q4,5,J+K,Lok Ma Chau,Arrival,31141,3675,405,35221
10/6/2019,Q4,5,J+K,Lok Ma Chau,Departure,32722,15605,1987,50314
10/6/2019,Q4,5,J+K,Man Kam To,Arrival,4493,1421,23,5937
10/6/2019,Q4,5,J+K,Man Kam To,Departure,6568,2348,81,8997
10/6/2019,Q4,5,J+K,Sha Tau Kok,Arrival,2454,440,45,2939
10/6/2019,Q4,5,J+K,Sha Tau Kok,Departure,3046,997,238,4281
10/6/2019,Q4,5,J+K,Shenzhen Bay,Arrival,31129,7946,501,39576
10/6/2019,Q4,5,J+K,Shenzhen Bay,Departure,42761,22980,3417,69158
10/6/2019,Q4,5,J+K,China Ferry Terminal,Arrival,2536,494,504,3534
10/6/2019,Q4,5,J+K,China Ferry Terminal,Departure,3887,1118,895,5900
10/6/2019,Q4,5,J+K,Harbour Control,Arrival,0,0,71,71
10/6/2019,Q4,5,J+K,Harbour Control,Departure,0,0,0,0
10/6/2019,Q4,5,J+K,Kai Tak Cruise Terminal,Arrival,2374,2441,117,4932
10/6/2019,Q4,5,J+K,Kai Tak Cruise Terminal,Departure,1610,2129,148,3887
10/6/2019,Q4,5,J+K,Macau Ferry Terminal,Arrival,7694,604,1238,9536
10/6/2019,Q4,5,J+K,Macau Ferry Terminal,Departure,10220,604,1305,12129
10/6/2019,Q4,5,J+K,Tuen Mun Ferry Terminal,Arrival,903,17,27,947
10/6/2019,Q4,5,J+K,Tuen Mun Ferry Terminal,Departure,966,8,18,992
10/7/2019,Q4,5,J+K,Airport,Arrival,46464,29626,12379,88469
10/7/2019,Q4,5,J+K,Airport,Departure,28561,8097,10192,46850
10/7/2019,Q4,5,J+K,Express Rail Link West Kowloon,Arrival,19922,2736,288,22946
10/7/2019,Q4,5,J+K,Express Rail Link West Kowloon,Departure,5765,9487,1021,16273
10/7/2019,Q4,5,J+K,Hung Hom,Arrival,0,0,0,0
10/7/2019,Q4,5,J+K,Hung Hom,Departure,0,0,0,0
10/7/2019,Q4,5,J+K,Lo Wu,Arrival,59819,5910,350,66079
10/7/2019,Q4,5,J+K,Lo Wu,Departure,26459,6639,561,33659
10/7/2019,Q4,5,J+K,Lok Ma Chau Spur Line,Arrival,51746,9747,196,61689
10/7/2019,Q4,5,J+K,Lok Ma Chau Spur Line,Departure,27817,10670,622,39109
10/7/2019,Q4,5,J+K,Hong Kong-Zhuhai-Macao Bridge,Arrival,35099,2126,1217,38442
10/7/2019,Q4,5,J+K,Hong Kong-Zhuhai-Macao Bridge,Departure,11126,3556,2332,17014
10/7/2019,Q4,5,J+K,Lok Ma Chau,Arrival,58906,4663,489,64058
10/7/2019,Q4,5,J+K,Lok Ma Chau,Departure,22568,15847,2048,40463
10/7/2019,Q4,5,J+K,Man Kam To,Arrival,9265,1967,46,11278
10/7/2019,Q4,5,J+K,Man Kam To,Departure,4838,2317,120,7275
10/7/2019,Q4,5,J+K,Sha Tau Kok,Arrival,5217,499,48,5764
10/7/2019,Q4,5,J+K,Sha Tau Kok,Departure,2172,858,166,3196
10/7/2019,Q4,5,J+K,Shenzhen Bay,Arrival,72603,8429,623,81655
10/7/2019,Q4,5,J+K,Shenzhen Bay,Departure,23596,19528,2518,45642
10/7/2019,Q4,5,J+K,China Ferry Terminal,Arrival,6412,457,460,7329
10/7/2019,Q4,5,J+K,China Ferry Terminal,Departure,1860,701,703,3264
10/7/2019,Q4,5,J+K,Harbour Control,Arrival,4,0,51,55
10/7/2019,Q4,5,J+K,Harbour Control,Departure,1,0,8,9
10/7/2019,Q4,5,J+K,Kai Tak Cruise Terminal,Arrival,933,72,20,1025
10/7/2019,Q4,5,J+K,Kai Tak Cruise Terminal,Departure,762,60,9,831
10/7/2019,Q4,5,J+K,Macau Ferry Terminal,Arrival,12763,430,948,14141
10/7/2019,Q4,5,J+K,Macau Ferry Terminal,Departure,6404,384,1320,8108
10/7/2019,Q4,5,J+K,Tuen Mun Ferry Terminal,Arrival,1370,11,8,1389
10/7/2019,Q4,5,J+K,Tuen Mun Ferry Terminal,Departure,565,5,21,591
12/21/2019,Q4,5,L+A,Airport,Arrival,34643,8904,17560,61107
12/21/2019,Q4,5,L+A,Airport,Departure,71827,4102,11322,87251
12/21/2019,Q4,5,L+A,Express Rail Link West Kowloon,Arrival,6682,10099,780,17561
12/21/2019,Q4,5,L+A,Express Rail Link West Kowloon,Departure,23786,10473,712,34971
12/21/2019,Q4,5,L+A,Hung Hom,Arrival,780,504,106,1390
12/21/2019,Q4,5,L+A,Hung Hom,Departure,1920,539,95,2554
12/21/2019,Q4,5,L+A,Lo Wu,Arrival,71035,23848,1079,95962
12/21/2019,Q4,5,L+A,Lo Wu,Departure,113282,26904,1105,141291
12/21/2019,Q4,5,L+A,Lok Ma Chau Spur Line,Arrival,37999,26556,563,65118
12/21/2019,Q4,5,L+A,Lok Ma Chau Spur Line,Departure,56598,26377,498,83473
12/21/2019,Q4,5,L+A,Hong Kong-Zhuhai-Macao Bridge,Arrival,11033,2312,2995,16340
12/21/2019,Q4,5,L+A,Hong Kong-Zhuhai-Macao Bridge,Departure,19361,4052,3567,26980
12/21/2019,Q4,5,L+A,Lok Ma Chau,Arrival,22304,5833,855,28992
12/21/2019,Q4,5,L+A,Lok Ma Chau,Departure,27253,6852,622,34727
12/21/2019,Q4,5,L+A,Man Kam To,Arrival,1848,2208,19,4075
12/21/2019,Q4,5,L+A,Man Kam To,Departure,2649,1676,41,4366
12/21/2019,Q4,5,L+A,Sha Tau Kok,Arrival,2104,994,76,3174
12/21/2019,Q4,5,L+A,Sha Tau Kok,Departure,3564,830,60,4454
12/21/2019,Q4,5,L+A,Shenzhen Bay,Arrival,24770,20023,1472,46265
12/21/2019,Q4,5,L+A,Shenzhen Bay,Departure,45349,21947,1210,68506
12/21/2019,Q4,5,L+A,China Ferry Terminal,Arrival,1905,781,592,3278
12/21/2019,Q4,5,L+A,China Ferry Terminal,Departure,2836,957,505,4298
12/21/2019,Q4,5,L+A,Harbour Control,Arrival,0,6,52,58
12/21/2019,Q4,5,L+A,Harbour Control,Departure,0,0,10,10
12/21/2019,Q4,5,L+A,Kai Tak Cruise Terminal,Arrival,450,3836,1729,6015
12/21/2019,Q4,5,L+A,Kai Tak Cruise Terminal,Departure,1761,3834,2559,8154
12/21/2019,Q4,5,L+A,Macau Ferry Terminal,Arrival,7128,535,1911,9574
12/21/2019,Q4,5,L+A,Macau Ferry Terminal,Departure,10445,602,2139,13186
12/21/2019,Q4,5,L+A,Tuen Mun Ferry Terminal,Arrival,430,9,54,493
12/21/2019,Q4,5,L+A,Tuen Mun Ferry Terminal,Departure,536,9,22,567
12/22/2019,Q4,5,L+A,Airport,Arrival,37576,7477,16617,61670
12/22/2019,Q4,5,L+A,Airport,Departure,60705,5050,13283,79038
12/22/2019,Q4,5,L+A,Express Rail Link West Kowloon,Arrival,9440,5087,635,15162
12/22/2019,Q4,5,L+A,Express Rail Link West Kowloon,Departure,14174,7518,824,22516
12/22/2019,Q4,5,L+A,Hung Hom,Arrival,1120,205,86,1411
12/22/2019,Q4,5,L+A,Hung Hom,Departure,1084,404,130,1618
12/22/2019,Q4,5,L+A,Lo Wu,Arrival,85117,14791,992,100900
12/22/2019,Q4,5,L+A,Lo Wu,Departure,75786,18687,1104,95577
12/22/2019,Q4,5,L+A,Lok Ma Chau Spur Line,Arrival,43899,18625,493,63017
12/22/2019,Q4,5,L+A,Lok Ma Chau Spur Line,Departure,42036,19497,609,62142
12/22/2019,Q4,5,L+A,Hong Kong-Zhuhai-Macao Bridge,Arrival,16287,1742,3228,21257
12/22/2019,Q4,5,L+A,Hong Kong-Zhuhai-Macao Bridge,Departure,19028,3567,3896,26491
12/22/2019,Q4,5,L+A,Lok Ma Chau,Arrival,25770,4771,602,31143
12/22/2019,Q4,5,L+A,Lok Ma Chau,Departure,20477,5491,817,26785
12/22/2019,Q4,5,L+A,Man Kam To,Arrival,1983,1284,22,3289
12/22/2019,Q4,5,L+A,Man Kam To,Departure,1707,1014,17,2738
12/22/2019,Q4,5,L+A,Sha Tau Kok,Arrival,2466,441,65,2972
12/22/2019,Q4,5,L+A,Sha Tau Kok,Departure,2193,527,104,2824
12/22/2019,Q4,5,L+A,Shenzhen Bay,Arrival,32317,11368,985,44670
12/22/2019,Q4,5,L+A,Shenzhen Bay,Departure,33036,14605,1335,48976
12/22/2019,Q4,5,L+A,China Ferry Terminal,Arrival,2327,390,610,3327
12/22/2019,Q4,5,L+A,China Ferry Terminal,Departure,2676,699,783,4158
12/22/2019,Q4,5,L+A,Harbour Control,Arrival,0,0,236,236
12/22/2019,Q4,5,L+A,Harbour Control,Departure,1,0,29,30
12/22/2019,Q4,5,L+A,Kai Tak Cruise Terminal,Arrival,5183,1809,611,7603
12/22/2019,Q4,5,L+A,Kai Tak Cruise Terminal,Departure,4784,480,2321,7585
12/22/2019,Q4,5,L+A,Macau Ferry Terminal,Arrival,9396,356,1698,11450
12/22/2019,Q4,5,L+A,Macau Ferry Terminal,Departure,10520,402,2120,13042
12/22/2019,Q4,5,L+A,Tuen Mun Ferry Terminal,Arrival,567,12,41,620
12/22/2019,Q4,5,L+A,Tuen Mun Ferry Terminal,Departure,880,7,42,929
12/23/2019,Q4,5,L+A,Airport,Arrival,33497,7607,18021,59125
12/23/2019,Q4,5,L+A,Airport,Departure,56357,4638,13002,73997
12/23/2019,Q4,5,L+A,Express Rail Link West Kowloon,Arrival,10265,9172,748,20185
12/23/2019,Q4,5,L+A,Express Rail Link West Kowloon,Departure,15718,8189,819,24726
12/23/2019,Q4,5,L+A,Hung Hom,Arrival,984,586,141,1711
12/23/2019,Q4,5,L+A,Hung Hom,Departure,1907,481,125,2513
12/23/2019,Q4,5,L+A,Lo Wu,Arrival,77776,21056,1046,99878
12/23/2019,Q4,5,L+A,Lo Wu,Departure,90938,21086,1262,113286
12/23/2019,Q4,5,L+A,Lok Ma Chau Spur Line,Arrival,41186,17199,485,58870
12/23/2019,Q4,5,L+A,Lok Ma Chau Spur Line,Departure,47320,15521,567,63408
12/23/2019,Q4,5,L+A,Hong Kong-Zhuhai-Macao Bridge,Arrival,15907,2760,4447,23114
12/23/2019,Q4,5,L+A,Hong Kong-Zhuhai-Macao Bridge,Departure,21581,3677,4985,30243
12/23/2019,Q4,5,L+A,Lok Ma Chau,Arrival,23263,7067,557,30887
12/23/2019,Q4,5,L+A,Lok Ma Chau,Departure,22838,7262,841,30941
12/23/2019,Q4,5,L+A,Man Kam To,Arrival,1967,1655,35,3657
12/23/2019,Q4,5,L+A,Man Kam To,Departure,2227,1403,22,3652
12/23/2019,Q4,5,L+A,Sha Tau Kok,Arrival,2118,746,63,2927
12/23/2019,Q4,5,L+A,Sha Tau Kok,Departure,2668,571,92,3331
12/23/2019,Q4,5,L+A,Shenzhen Bay,Arrival,27281,14523,1110,42914
12/23/2019,Q4,5,L+A,Shenzhen Bay,Departure,36560,13958,1472,51990
12/23/2019,Q4,5,L+A,China Ferry Terminal,Arrival,2887,1088,884,4859
12/23/2019,Q4,5,L+A,China Ferry Terminal,Departure,3181,823,872,4876
12/23/2019,Q4,5,L+A,Harbour Control,Arrival,1,0,33,34
12/23/2019,Q4,5,L+A,Harbour Control,Departure,1,0,22,23
12/23/2019,Q4,5,L+A,Kai Tak Cruise Terminal,Arrival,378,26,21,425
12/23/2019,Q4,5,L+A,Kai Tak Cruise Terminal,Departure,685,50,16,751
12/23/2019,Q4,5,L+A,Macau Ferry Terminal,Arrival,9857,608,2750,13215
12/23/2019,Q4,5,L+A,Macau Ferry Terminal,Departure,11425,655,2696,14776
12/23/2019,Q4,5,L+A,Tuen Mun Ferry Terminal,Arrival,841,3,45,889
12/23/2019,Q4,5,L+A,Tuen Mun Ferry Terminal,Departure,819,6,27,852
12/24/2019,Q4,5,L+A,Airport,Arrival,31465,5541,17399,54405
12/24/2019,Q4,5,L+A,Airport,Departure,61634,3685,9656,74975
12/24/2019,Q4,5,L+A,Express Rail Link West Kowloon,Arrival,8014,8152,597,16763
12/24/2019,Q4,5,L+A,Express Rail Link West Kowloon,Departure,23669,7677,731,32077
12/24/2019,Q4,5,L+A,Hung Hom,Arrival,825,472,115,1412
12/24/2019,Q4,5,L+A,Hung Hom,Departure,2090,448,126,2664
12/24/2019,Q4,5,L+A,Lo Wu,Arrival,67387,20568,889,88844
12/24/2019,Q4,5,L+A,Lo Wu,Departure,114915,21854,1063,137832
12/24/2019,Q4,5,L+A,Lok Ma Chau Spur Line,Arrival,36892,16518,506,53916
12/24/2019,Q4,5,L+A,Lok Ma Chau Spur Line,Departure,53395,15512,445,69352
12/24/2019,Q4,5,L+A,Hong Kong-Zhuhai-Macao Bridge,Arrival,15468,2342,3526,21336
12/24/2019,Q4,5,L+A,Hong Kong-Zhuhai-Macao Bridge,Departure,28661,3340,5226,37227
12/24/2019,Q4,5,L+A,Lok Ma Chau,Arrival,20887,5102,531,26520
12/24/2019,Q4,5,L+A,Lok Ma Chau,Departure,27621,6321,686,34628
12/24/2019,Q4,5,L+A,Man Kam To,Arrival,1829,1692,21,3542
12/24/2019,Q4,5,L+A,Man Kam To,Departure,2360,1144,15,3519
12/24/2019,Q4,5,L+A,Sha Tau Kok,Arrival,1832,639,79,2550
12/24/2019,Q4,5,L+A,Sha Tau Kok,Departure,3098,584,85,3767
12/24/2019,Q4,5,L+A,Shenzhen Bay,Arrival,23872,12925,902,37699
12/24/2019,Q4,5,L+A,Shenzhen Bay,Departure,44284,13095,1116,58495
12/24/2019,Q4,5,L+A,China Ferry Terminal,Arrival,2249,871,682,3802
12/24/2019,Q4,5,L+A,China Ferry Terminal,Departure,3712,858,625,5195
12/24/2019,Q4,5,L+A,Harbour Control,Arrival,2,0,40,42
12/24/2019,Q4,5,L+A,Harbour Control,Departure,2,0,5,7
12/24/2019,Q4,5,L+A,Kai Tak Cruise Terminal,Arrival,683,50,4,737
12/24/2019,Q4,5,L+A,Kai Tak Cruise Terminal,Departure,902,129,9,1040
12/24/2019,Q4,5,L+A,Macau Ferry Terminal,Arrival,9469,523,2142,12134
12/24/2019,Q4,5,L+A,Macau Ferry Terminal,Departure,13243,648,2144,16035
12/24/2019,Q4,5,L+A,Tuen Mun Ferry Terminal,Arrival,677,9,24,710
12/24/2019,Q4,5,L+A,Tuen Mun Ferry Terminal,Departure,639,11,17,667
12/25/2019,Q4,5,L+A,Airport,Arrival,36967,4956,18860,60783
12/25/2019,Q4,5,L+A,Airport,Departure,58138,3320,10775,72233
12/25/2019,Q4,5,L+A,Express Rail Link West Kowloon,Arrival,8799,4560,519,13878
12/25/2019,Q4,5,L+A,Express Rail Link West Kowloon,Departure,25300,5777,651,31728
12/25/2019,Q4,5,L+A,Hung Hom,Arrival,800,300,69,1169
12/25/2019,Q4,5,L+A,Hung Hom,Departure,2442,370,100,2912
12/25/2019,Q4,5,L+A,Lo Wu,Arrival,86038,15714,758,102510
12/25/2019,Q4,5,L+A,Lo Wu,Departure,127625,18443,978,147046
12/25/2019,Q4,5,L+A,Lok Ma Chau Spur Line,Arrival,47218,13181,356,60755
12/25/2019,Q4,5,L+A,Lok Ma Chau Spur Line,Departure,71808,12867,394,85069
12/25/2019,Q4,5,L+A,Hong Kong-Zhuhai-Macao Bridge,Arrival,26409,2046,2792,31247
12/25/2019,Q4,5,L+A,Hong Kong-Zhuhai-Macao Bridge,Departure,49763,3351,6794,59908
12/25/2019,Q4,5,L+A,Lok Ma Chau,Arrival,25269,4067,473,29809
12/25/2019,Q4,5,L+A,Lok Ma Chau,Departure,29031,4960,602,34593
12/25/2019,Q4,5,L+A,Man Kam To,Arrival,1629,1351,37,3017
12/25/2019,Q4,5,L+A,Man Kam To,Departure,2365,861,27,3253
12/25/2019,Q4,5,L+A,Sha Tau Kok,Arrival,2030,405,50,2485
12/25/2019,Q4,5,L+A,Sha Tau Kok,Departure,3606,373,73,4052
12/25/2019,Q4,5,L+A,Shenzhen Bay,Arrival,31012,8648,829,40489
12/25/2019,Q4,5,L+A,Shenzhen Bay,Departure,59558,10070,1025,70653
12/25/2019,Q4,5,L+A,China Ferry Terminal,Arrival,2350,466,534,3350
12/25/2019,Q4,5,L+A,China Ferry Terminal,Departure,5931,672,615,7218
12/25/2019,Q4,5,L+A,Harbour Control,Arrival,1,0,21,22
12/25/2019,Q4,5,L+A,Harbour Control,Departure,0,0,0,0
12/25/2019,Q4,5,L+A,Kai Tak Cruise Terminal,Arrival,909,129,2404,3442
12/25/2019,Q4,5,L+A,Kai Tak Cruise Terminal,Departure,877,116,13,1006
12/25/2019,Q4,5,L+A,Macau Ferry Terminal,Arrival,10364,467,1531,12362
12/25/2019,Q4,5,L+A,Macau Ferry Terminal,Departure,16498,507,1940,18945
12/25/2019,Q4,5,L+A,Tuen Mun Ferry Terminal,Arrival,827,5,11,843
12/25/2019,Q4,5,L+A,Tuen Mun Ferry Terminal,Departure,1135,10,41,1186
12/26/2019,Q4,5,L+A,Airport,Arrival,47191,4930,18714,70835
12/26/2019,Q4,5,L+A,Airport,Departure,44335,3702,15898,63935
12/26/2019,Q4,5,L+A,Express Rail Link West Kowloon,Arrival,20703,5179,558,26440
12/26/2019,Q4,5,L+A,Express Rail Link West Kowloon,Departure,12172,4967,706,17845
12/26/2019,Q4,5,L+A,Hung Hom,Arrival,2123,424,99,2646
12/26/2019,Q4,5,L+A,Hung Hom,Departure,1212,352,78,1642
12/26/2019,Q4,5,L+A,Lo Wu,Arrival,127800,15591,942,144333
12/26/2019,Q4,5,L+A,Lo Wu,Departure,74553,16564,958,92075
12/26/2019,Q4,5,L+A,Lok Ma Chau Spur Line,Arrival,63499,12940,367,76806
12/26/2019,Q4,5,L+A,Lok Ma Chau Spur Line,Departure,41502,12009,306,53817
12/26/2019,Q4,5,L+A,Hong Kong-Zhuhai-Macao Bridge,Arrival,44041,2555,3033,49629
12/26/2019,Q4,5,L+A,Hong Kong-Zhuhai-Macao Bridge,Departure,24603,3303,4483,32389
12/26/2019,Q4,5,L+A,Lok Ma Chau,Arrival,33190,4136,664,37990
12/26/2019,Q4,5,L+A,Lok Ma Chau,Departure,19241,3904,559,23704
12/26/2019,Q4,5,L+A,Man Kam To,Arrival,2232,1350,31,3613
12/26/2019,Q4,5,L+A,Man Kam To,Departure,1588,873,14,2475
12/26/2019,Q4,5,L+A,Sha Tau Kok,Arrival,3462,529,63,4054
12/26/2019,Q4,5,L+A,Sha Tau Kok,Departure,2089,423,63,2575
12/26/2019,Q4,5,L+A,Shenzhen Bay,Arrival,60585,9914,896,71395
12/26/2019,Q4,5,L+A,Shenzhen Bay,Departure,28698,9537,775,39010
12/26/2019,Q4,5,L+A,China Ferry Terminal,Arrival,5799,522,650,6971
12/26/2019,Q4,5,L+A,China Ferry Terminal,Departure,3193,705,961,4859
12/26/2019,Q4,5,L+A,Harbour Control,Arrival,0,0,38,38
12/26/2019,Q4,5,L+A,Harbour Control,Departure,0,0,1,1
12/26/2019,Q4,5,L+A,Kai Tak Cruise Terminal,Arrival,2306,116,35,2457
12/26/2019,Q4,5,L+A,Kai Tak Cruise Terminal,Departure,721,97,43,861
12/26/2019,Q4,5,L+A,Macau Ferry Terminal,Arrival,17409,479,1761,19649
12/26/2019,Q4,5,L+A,Macau Ferry Terminal,Departure,10869,512,2194,13575
12/26/2019,Q4,5,L+A,Tuen Mun Ferry Terminal,Arrival,1328,14,18,1360
12/26/2019,Q4,5,L+A,Tuen Mun Ferry Terminal,Departure,796,7,20,823
12/27/2019,Q4,5,L+A,Airport,Arrival,45092,5647,18949,69688
12/27/2019,Q4,5,L+A,Airport,Departure,49396,4516,14751,68663
12/27/2019,Q4,5,L+A,Express Rail Link West Kowloon,Arrival,14835,8725,841,24401
12/27/2019,Q4,5,L+A,Express Rail Link West Kowloon,Departure,12321,7451,750,20522
12/27/2019,Q4,5,L+A,Hung Hom,Arrival,1542,543,146,2231
12/27/2019,Q4,5,L+A,Hung Hom,Departure,1649,489,118,2256
12/27/2019,Q4,5,L+A,Lo Wu,Arrival,85184,21214,1186,107584
12/27/2019,Q4,5,L+A,Lo Wu,Departure,79766,21496,1134,102396
12/27/2019,Q4,5,L+A,Lok Ma Chau Spur Line,Arrival,46481,17890,568,64939
12/27/2019,Q4,5,L+A,Lok Ma Chau Spur Line,Departure,41750,15756,445,57951
12/27/2019,Q4,5,L+A,Hong Kong-Zhuhai-Macao Bridge,Arrival,24533,2497,3201,30231
12/27/2019,Q4,5,L+A,Hong Kong-Zhuhai-Macao Bridge,Departure,20652,4257,4372,29281
12/27/2019,Q4,5,L+A,Lok Ma Chau,Arrival,26181,6465,901,33547
12/27/2019,Q4,5,L+A,Lok Ma Chau,Departure,20659,5319,617,26595
12/27/2019,Q4,5,L+A,Man Kam To,Arrival,2263,1678,21,3962
12/27/2019,Q4,5,L+A,Man Kam To,Departure,1981,1122,25,3128
12/27/2019,Q4,5,L+A,Sha Tau Kok,Arrival,2487,674,103,3264
12/27/2019,Q4,5,L+A,Sha Tau Kok,Departure,2174,548,59,2781
12/27/2019,Q4,5,L+A,Shenzhen Bay,Arrival,35323,14629,1374,51326
12/27/2019,Q4,5,L+A,Shenzhen Bay,Departure,30441,13317,1027,44785
12/27/2019,Q4,5,L+A,China Ferry Terminal,Arrival,3946,849,1033,5828
12/27/2019,Q4,5,L+A,China Ferry Terminal,Departure,2715,876,955,4546
12/27/2019,Q4,5,L+A,Harbour Control,Arrival,0,0,227,227
12/27/2019,Q4,5,L+A,Harbour Control,Departure,6,0,15,21
12/27/2019,Q4,5,L+A,Kai Tak Cruise Terminal,Arrival,2386,313,171,2870
12/27/2019,Q4,5,L+A,Kai Tak Cruise Terminal,Departure,3367,360,3102,6829
12/27/2019,Q4,5,L+A,Macau Ferry Terminal,Arrival,13405,621,2919,16945
12/27/2019,Q4,5,L+A,Macau Ferry Terminal,Departure,11577,629,2886,15092
12/27/2019,Q4,5,L+A,Tuen Mun Ferry Terminal,Arrival,902,10,25,937
12/27/2019,Q4,5,L+A,Tuen Mun Ferry Terminal,Departure,756,5,26,787
12/28/2019,Q4,5,L+A,Airport,Arrival,52705,5088,20784,78577
12/28/2019,Q4,5,L+A,Airport,Departure,39197,5306,15715,60218
12/28/2019,Q4,5,L+A,Express Rail Link West Kowloon,Arrival,14703,9205,897,24805
12/28/2019,Q4,5,L+A,Express Rail Link West Kowloon,Departure,11581,8326,733,20640
12/28/2019,Q4,5,L+A,Hung Hom,Arrival,1355,377,128,1860
12/28/2019,Q4,5,L+A,Hung Hom,Departure,1306,382,106,1794
12/28/2019,Q4,5,L+A,Lo Wu,Arrival,78697,22234,1356,102287
12/28/2019,Q4,5,L+A,Lo Wu,Departure,93192,24405,1087,118684
12/28/2019,Q4,5,L+A,Lok Ma Chau Spur Line,Arrival,44287,27320,516,72123
12/28/2019,Q4,5,L+A,Lok Ma Chau Spur Line,Departure,49172,26015,444,75631
12/28/2019,Q4,5,L+A,Hong Kong-Zhuhai-Macao Bridge,Arrival,23282,2729,3736,29747
12/28/2019,Q4,5,L+A,Hong Kong-Zhuhai-Macao Bridge,Departure,23640,4086,4911,32637
12/28/2019,Q4,5,L+A,Lok Ma Chau,Arrival,23586,6926,847,31359
12/28/2019,Q4,5,L+A,Lok Ma Chau,Departure,22954,5235,581,28770
12/28/2019,Q4,5,L+A,Man Kam To,Arrival,1984,2189,12,4185
12/28/2019,Q4,5,L+A,Man Kam To,Departure,2097,1643,35,3775
12/28/2019,Q4,5,L+A,Sha Tau Kok,Arrival,2131,750,76,2957
12/28/2019,Q4,5,L+A,Sha Tau Kok,Departure,2372,635,38,3045
12/28/2019,Q4,5,L+A,Shenzhen Bay,Arrival,32617,20750,1308,54675
12/28/2019,Q4,5,L+A,Shenzhen Bay,Departure,35882,19865,1069,56816
12/28/2019,Q4,5,L+A,China Ferry Terminal,Arrival,3295,763,1157,5215
12/28/2019,Q4,5,L+A,China Ferry Terminal,Departure,3145,747,949,4841
12/28/2019,Q4,5,L+A,Harbour Control,Arrival,0,0,44,44
12/28/2019,Q4,5,L+A,Harbour Control,Departure,0,0,16,16
12/28/2019,Q4,5,L+A,Kai Tak Cruise Terminal,Arrival,214,4118,52,4384
12/28/2019,Q4,5,L+A,Kai Tak Cruise Terminal,Departure,212,4115,54,4381
12/28/2019,Q4,5,L+A,Macau Ferry Terminal,Arrival,11983,469,3065,15517
12/28/2019,Q4,5,L+A,Macau Ferry Terminal,Departure,12632,578,2740,15950
12/28/2019,Q4,5,L+A,Tuen Mun Ferry Terminal,Arrival,753,16,35,804
12/28/2019,Q4,5,L+A,Tuen Mun Ferry Terminal,Departure,709,10,30,749
12/29/2019,Q4,5,L+A,Airport,Arrival,68857,4043,15071,87971
12/29/2019,Q4,5,L+A,Airport,Departure,34214,5197,18618,58029
12/29/2019,Q4,5,L+A,Express Rail Link West Kowloon,Arrival,21898,6316,807,29021
12/29/2019,Q4,5,L+A,Express Rail Link West Kowloon,Departure,7820,7210,714,15744
12/29/2019,Q4,5,L+A,Hung Hom,Arrival,2361,270,126,2757
12/29/2019,Q4,5,L+A,Hung Hom,Departure,909,565,130,1604
12/29/2019,Q4,5,L+A,Lo Wu,Arrival,105272,17421,1284,123977
12/29/2019,Q4,5,L+A,Lo Wu,Departure,68849,20296,1133,90278
12/29/2019,Q4,5,L+A,Lok Ma Chau Spur Line,Arrival,52506,21017,465,73988
12/29/2019,Q4,5,L+A,Lok Ma Chau Spur Line,Departure,36680,21319,420,58419
12/29/2019,Q4,5,L+A,Hong Kong-Zhuhai-Macao Bridge,Arrival,28882,2493,3261,34636
12/29/2019,Q4,5,L+A,Hong Kong-Zhuhai-Macao Bridge,Departure,18039,5016,4424,27479
12/29/2019,Q4,5,L+A,Lok Ma Chau,Arrival,28831,5042,705,34578
12/29/2019,Q4,5,L+A,Lok Ma Chau,Departure,17354,4405,471,22230
12/29/2019,Q4,5,L+A,Man Kam To,Arrival,2185,1533,24,3742
12/29/2019,Q4,5,L+A,Man Kam To,Departure,1325,1004,22,2351
12/29/2019,Q4,5,L+A,Sha Tau Kok,Arrival,2883,562,75,3520
12/29/2019,Q4,5,L+A,Sha Tau Kok,Departure,1713,567,48,2328
12/29/2019,Q4,5,L+A,Shenzhen Bay,Arrival,52401,14520,1147,68068
12/29/2019,Q4,5,L+A,Shenzhen Bay,Departure,27509,16198,846,44553
12/29/2019,Q4,5,L+A,China Ferry Terminal,Arrival,3841,557,986,5384
12/29/2019,Q4,5,L+A,China Ferry Terminal,Departure,1933,703,1116,3752
12/29/2019,Q4,5,L+A,Harbour Control,Arrival,0,0,205,205
12/29/2019,Q4,5,L+A,Harbour Control,Departure,0,0,1,1
12/29/2019,Q4,5,L+A,Kai Tak Cruise Terminal,Arrival,5895,628,2230,8753
12/29/2019,Q4,5,L+A,Kai Tak Cruise Terminal,Departure,3296,706,2560,6562
12/29/2019,Q4,5,L+A,Macau Ferry Terminal,Arrival,13038,440,2626,16104
12/29/2019,Q4,5,L+A,Macau Ferry Terminal,Departure,9147,416,2774,12337
12/29/2019,Q4,5,L+A,Tuen Mun Ferry Terminal,Arrival,837,9,25,871
12/29/2019,Q4,5,L+A,Tuen Mun Ferry Terminal,Departure,587,0,24,611
12/30/2019,Q4,5,L+A,Airport,Arrival,58966,4999,18078,82043
12/30/2019,Q4,5,L+A,Airport,Departure,27989,4963,17085,50037
12/30/2019,Q4,5,L+A,Express Rail Link West Kowloon,Arrival,15359,8155,1052,24566
12/30/2019,Q4,5,L+A,Express Rail Link West Kowloon,Departure,8018,7427,730,16175
12/30/2019,Q4,5,L+A,Hung Hom,Arrival,1426,490,178,2094
12/30/2019,Q4,5,L+A,Hung Hom,Departure,1281,512,113,1906
12/30/2019,Q4,5,L+A,Lo Wu,Arrival,86161,19281,1275,106717
12/30/2019,Q4,5,L+A,Lo Wu,Departure,76290,19184,1191,96665
12/30/2019,Q4,5,L+A,Lok Ma Chau Spur Line,Arrival,44897,16618,483,61998
12/30/2019,Q4,5,L+A,Lok Ma Chau Spur Line,Departure,39914,14679,475,55068
12/30/2019,Q4,5,L+A,Hong Kong-Zhuhai-Macao Bridge,Arrival,18713,2268,3760,24741
12/30/2019,Q4,5,L+A,Hong Kong-Zhuhai-Macao Bridge,Departure,15315,3596,4501,23412
12/30/2019,Q4,5,L+A,Lok Ma Chau,Arrival,25832,8104,599,34535
12/30/2019,Q4,5,L+A,Lok Ma Chau,Departure,20952,5759,524,27235
12/30/2019,Q4,5,L+A,Man Kam To,Arrival,2256,1712,12,3980
12/30/2019,Q4,5,L+A,Man Kam To,Departure,1867,1061,12,2940
12/30/2019,Q4,5,L+A,Sha Tau Kok,Arrival,2373,653,66,3092
12/30/2019,Q4,5,L+A,Sha Tau Kok,Departure,2283,521,69,2873
12/30/2019,Q4,5,L+A,Shenzhen Bay,Arrival,36863,13269,1294,51426
12/30/2019,Q4,5,L+A,Shenzhen Bay,Departure,26718,12663,1011,40392
12/30/2019,Q4,5,L+A,China Ferry Terminal,Arrival,3032,977,1338,5347
12/30/2019,Q4,5,L+A,China Ferry Terminal,Departure,2359,902,1093,4354
12/30/2019,Q4,5,L+A,Harbour Control,Arrival,0,0,40,40
12/30/2019,Q4,5,L+A,Harbour Control,Departure,1,0,1,2
12/30/2019,Q4,5,L+A,Kai Tak Cruise Terminal,Arrival,555,57,2867,3479
12/30/2019,Q4,5,L+A,Kai Tak Cruise Terminal,Departure,486,59,26,571
12/30/2019,Q4,5,L+A,Macau Ferry Terminal,Arrival,10498,567,3302,14367
12/30/2019,Q4,5,L+A,Macau Ferry Terminal,Departure,9942,543,2983,13468
12/30/2019,Q4,5,L+A,Tuen Mun Ferry Terminal,Arrival,626,5,30,661
12/30/2019,Q4,5,L+A,Tuen Mun Ferry Terminal,Departure,601,4,23,628
12/31/2019,Q4,5,L+A,Airport,Arrival,58757,4109,14087,76953
12/31/2019,Q4,5,L+A,Airport,Departure,26654,5183,14984,46821
12/31/2019,Q4,5,L+A,Express Rail Link West Kowloon,Arrival,13602,7453,1188,22243
12/31/2019,Q4,5,L+A,Express Rail Link West Kowloon,Departure,9502,6318,502,16322
12/31/2019,Q4,5,L+A,Hung Hom,Arrival,1528,467,162,2157
12/31/2019,Q4,5,L+A,Hung Hom,Departure,1026,420,115,1561
12/31/2019,Q4,5,L+A,Lo Wu,Arrival,79480,19271,1102,99853
12/31/2019,Q4,5,L+A,Lo Wu,Departure,86505,19042,816,106363
12/31/2019,Q4,5,L+A,Lok Ma Chau Spur Line,Arrival,43113,16921,494,60528
12/31/2019,Q4,5,L+A,Lok Ma Chau Spur Line,Departure,45852,14823,331,61006
12/31/2019,Q4,5,L+A,Hong Kong-Zhuhai-Macao Bridge,Arrival,15091,2265,2835,20191
12/31/2019,Q4,5,L+A,Hong Kong-Zhuhai-Macao Bridge,Departure,16844,3196,3347,23387
12/31/2019,Q4,5,L+A,Lok Ma Chau,Arrival,22789,5464,724,28977
12/31/2019,Q4,5,L+A,Lok Ma Chau,Departure,24429,4928,410,29767
12/31/2019,Q4,5,L+A,Man Kam To,Arrival,2075,1388,27,3490
12/31/2019,Q4,5,L+A,Man Kam To,Departure,2063,973,14,3050
12/31/2019,Q4,5,L+A,Sha Tau Kok,Arrival,2426,652,102,3180
12/31/2019,Q4,5,L+A,Sha Tau Kok,Departure,2196,505,48,2749
12/31/2019,Q4,5,L+A,Shenzhen Bay,Arrival,34406,13059,1128,48593
12/31/2019,Q4,5,L+A,Shenzhen Bay,Departure,27484,11880,776,40140
12/31/2019,Q4,5,L+A,China Ferry Terminal,Arrival,2507,649,889,4045
12/31/2019,Q4,5,L+A,China Ferry Terminal,Departure,2055,767,780,3602
12/31/2019,Q4,5,L+A,Harbour Control,Arrival,31,0,63,94
12/31/2019,Q4,5,L+A,Harbour Control,Departure,0,0,3,3
12/31/2019,Q4,5,L+A,Kai Tak Cruise Terminal,Arrival,482,55,1559,2096
12/31/2019,Q4,5,L+A,Kai Tak Cruise Terminal,Departure,1101,94,2850,4045
12/31/2019,Q4,5,L+A,Macau Ferry Terminal,Arrival,8645,480,2471,11596
12/31/2019,Q4,5,L+A,Macau Ferry Terminal,Departure,10108,567,2221,12896
12/31/2019,Q4,5,L+A,Tuen Mun Ferry Terminal,Arrival,536,7,27,570
12/31/2019,Q4,5,L+A,Tuen Mun Ferry Terminal,Departure,558,5,14,577
1/1/2020,Q1,5,L+A,Airport,Arrival,66624,3733,11409,81766
1/1/2020,Q1,5,L+A,Airport,Departure,28618,4677,19370,52665
1/1/2020,Q1,5,L+A,Express Rail Link West Kowloon,Arrival,15040,6781,558,22379
1/1/2020,Q1,5,L+A,Express Rail Link West Kowloon,Departure,5699,7106,917,13722
1/1/2020,Q1,5,L+A,Hung Hom,Arrival,1262,272,82,1616
1/1/2020,Q1,5,L+A,Hung Hom,Departure,521,312,127,960
1/1/2020,Q1,5,L+A,Lo Wu,Arrival,89085,18772,820,108677
1/1/2020,Q1,5,L+A,Lo Wu,Departure,60030,20727,906,81663
1/1/2020,Q1,5,L+A,Lok Ma Chau Spur Line,Arrival,47703,20848,386,68937
1/1/2020,Q1,5,L+A,Lok Ma Chau Spur Line,Departure,33278,19336,488,53102
1/1/2020,Q1,5,L+A,Hong Kong-Zhuhai-Macao Bridge,Arrival,22679,2560,3541,28780
1/1/2020,Q1,5,L+A,Hong Kong-Zhuhai-Macao Bridge,Departure,13922,4611,3923,22456
1/1/2020,Q1,5,L+A,Lok Ma Chau,Arrival,28570,4410,465,33445
1/1/2020,Q1,5,L+A,Lok Ma Chau,Departure,16541,4677,614,21832
1/1/2020,Q1,5,L+A,Man Kam To,Arrival,1937,1335,15,3287
1/1/2020,Q1,5,L+A,Man Kam To,Departure,1373,916,6,2295
1/1/2020,Q1,5,L+A,Sha Tau Kok,Arrival,2285,543,51,2879
1/1/2020,Q1,5,L+A,Sha Tau Kok,Departure,1413,471,63,1947
1/1/2020,Q1,5,L+A,Shenzhen Bay,Arrival,38549,13755,848,53152
1/1/2020,Q1,5,L+A,Shenzhen Bay,Departure,21240,13247,1000,35487
1/1/2020,Q1,5,L+A,China Ferry Terminal,Arrival,2556,421,737,3714
1/1/2020,Q1,5,L+A,China Ferry Terminal,Departure,1242,566,923,2731
1/1/2020,Q1,5,L+A,Harbour Control,Arrival,1,0,24,25
1/1/2020,Q1,5,L+A,Harbour Control,Departure,0,0,14,14
1/1/2020,Q1,5,L+A,Kai Tak Cruise Terminal,Arrival,1081,79,16,1176
1/1/2020,Q1,5,L+A,Kai Tak Cruise Terminal,Departure,476,77,26,579
1/1/2020,Q1,5,L+A,Macau Ferry Terminal,Arrival,8883,505,1904,11292
1/1/2020,Q1,5,L+A,Macau Ferry Terminal,Departure,5755,414,2015,8184
1/1/2020,Q1,5,L+A,Tuen Mun Ferry Terminal,Arrival,686,10,23,719
1/1/2020,Q1,5,L+A,Tuen Mun Ferry Terminal,Departure,436,5,19,460
1/24/2020,Q1,5,B,Airport,Arrival,20724,9124,14116,43964
1/24/2020,Q1,5,B,Airport,Departure,74876,4451,7242,86569
1/24/2020,Q1,5,B,Express Rail Link West Kowloon,Arrival,1717,2380,337,4434
1/24/2020,Q1,5,B,Express Rail Link West Kowloon,Departure,20096,2800,316,23212
1/24/2020,Q1,5,B,Hung Hom,Arrival,433,470,71,974
1/24/2020,Q1,5,B,Hung Hom,Departure,3498,194,51,3743
1/24/2020,Q1,5,B,Lo Wu,Arrival,26340,7383,429,34152
1/24/2020,Q1,5,B,Lo Wu,Departure,72074,6231,413,78718
1/24/2020,Q1,5,B,Lok Ma Chau Spur Line,Arrival,16750,4979,196,21925
1/24/2020,Q1,5,B,Lok Ma Chau Spur Line,Departure,32215,3766,167,36148
1/24/2020,Q1,5,B,Hong Kong-Zhuhai-Macao Bridge,Arrival,7294,1949,2130,11373
1/24/2020,Q1,5,B,Hong Kong-Zhuhai-Macao Bridge,Departure,15775,2804,2086,20665
1/24/2020,Q1,5,B,Lok Ma Chau,Arrival,10591,2921,407,13919
1/24/2020,Q1,5,B,Lok Ma Chau,Departure,17682,3901,283,21866
1/24/2020,Q1,5,B,Man Kam To,Arrival,1093,367,9,1469
1/24/2020,Q1,5,B,Man Kam To,Departure,1890,219,9,2118
1/24/2020,Q1,5,B,Sha Tau Kok,Arrival,1008,264,27,1299
1/24/2020,Q1,5,B,Sha Tau Kok,Departure,3207,210,40,3457
1/24/2020,Q1,5,B,Shenzhen Bay,Arrival,8792,5354,685,14831
1/24/2020,Q1,5,B,Shenzhen Bay,Departure,37864,5142,484,43490
1/24/2020,Q1,5,B,China Ferry Terminal,Arrival,1013,442,373,1828
1/24/2020,Q1,5,B,China Ferry Terminal,Departure,3511,453,312,4276
1/24/2020,Q1,5,B,Harbour Control,Arrival,7,0,259,266
1/24/2020,Q1,5,B,Harbour Control,Departure,77,0,4,81
1/24/2020,Q1,5,B,Kai Tak Cruise Terminal,Arrival,466,707,2400,3573
1/24/2020,Q1,5,B,Kai Tak Cruise Terminal,Departure,2487,775,280,3542
1/24/2020,Q1,5,B,Macau Ferry Terminal,Arrival,6001,358,1395,7754
1/24/2020,Q1,5,B,Macau Ferry Terminal,Departure,8985,390,1314,10689
1/24/2020,Q1,5,B,Tuen Mun Ferry Terminal,Arrival,434,7,38,479
1/24/2020,Q1,5,B,Tuen Mun Ferry Terminal,Departure,548,4,17,569
1/25/2020,Q1,5,B,Airport,Arrival,14907,8489,10953,34349
1/25/2020,Q1,5,B,Airport,Departure,58711,5326,7335,71372
1/25/2020,Q1,5,B,Express Rail Link West Kowloon,Arrival,1852,2278,285,4415
1/25/2020,Q1,5,B,Express Rail Link West Kowloon,Departure,8489,2089,224,10802
1/25/2020,Q1,5,B,Hung Hom,Arrival,575,176,67,818
1/25/2020,Q1,5,B,Hung Hom,Departure,1509,153,53,1715
1/25/2020,Q1,5,B,Lo Wu,Arrival,20716,4368,317,25401
1/25/2020,Q1,5,B,Lo Wu,Departure,39692,5468,347,45507
1/25/2020,Q1,5,B,Lok Ma Chau Spur Line,Arrival,12511,3237,117,15865
1/25/2020,Q1,5,B,Lok Ma Chau Spur Line,Departure,16675,3347,155,20177
1/25/2020,Q1,5,B,Hong Kong-Zhuhai-Macao Bridge,Arrival,9121,2682,2339,14142
1/25/2020,Q1,5,B,Hong Kong-Zhuhai-Macao Bridge,Departure,13570,2949,1830,18349
1/25/2020,Q1,5,B,Lok Ma Chau,Arrival,7187,2662,234,10083
1/25/2020,Q1,5,B,Lok Ma Chau,Departure,10351,3163,195,13709
1/25/2020,Q1,5,B,Man Kam To,Arrival,753,262,12,1027
1/25/2020,Q1,5,B,Man Kam To,Departure,895,203,5,1103
1/25/2020,Q1,5,B,Sha Tau Kok,Arrival,923,208,19,1150
1/25/2020,Q1,5,B,Sha Tau Kok,Departure,1702,165,38,1905
1/25/2020,Q1,5,B,Shenzhen Bay,Arrival,9834,4540,532,14906
1/25/2020,Q1,5,B,Shenzhen Bay,Departure,20440,4993,451,25884
1/25/2020,Q1,5,B,China Ferry Terminal,Arrival,1183,463,499,2145
1/25/2020,Q1,5,B,China Ferry Terminal,Departure,2233,406,415,3054
1/25/2020,Q1,5,B,Harbour Control,Arrival,2,0,89,91
1/25/2020,Q1,5,B,Harbour Control,Departure,2,0,2,4
1/25/2020,Q1,5,B,Kai Tak Cruise Terminal,Arrival,168,25,2315,2508
1/25/2020,Q1,5,B,Kai Tak Cruise Terminal,Departure,2997,129,2521,5647
1/25/2020,Q1,5,B,Macau Ferry Terminal,Arrival,6118,490,1355,7963
1/25/2020,Q1,5,B,Macau Ferry Terminal,Departure,8120,378,1048,9546
1/25/2020,Q1,5,B,Tuen Mun Ferry Terminal,Arrival,567,11,44,622
1/25/2020,Q1,5,B,Tuen Mun Ferry Terminal,Departure,782,19,14,815
1/26/2020,Q1,5,B,Airport,Arrival,22646,10955,7522,41123
1/26/2020,Q1,5,B,Airport,Departure,47580,7870,8813,64263
1/26/2020,Q1,5,B,Express Rail Link West Kowloon,Arrival,7481,2481,415,10377
1/26/2020,Q1,5,B,Express Rail Link West Kowloon,Departure,2360,2875,300,5535
1/26/2020,Q1,5,B,Hung Hom,Arrival,2237,272,137,2646
1/26/2020,Q1,5,B,Hung Hom,Departure,575,307,54,936
1/26/2020,Q1,5,B,Lo Wu,Arrival,44781,4994,406,50181
1/26/2020,Q1,5,B,Lo Wu,Departure,22105,6754,348,29207
1/26/2020,Q1,5,B,Lok Ma Chau Spur Line,Arrival,19606,3816,265,23687
1/26/2020,Q1,5,B,Lok Ma Chau Spur Line,Departure,10678,4376,226,15280
1/26/2020,Q1,5,B,Hong Kong-Zhuhai-Macao Bridge,Arrival,12967,2486,2311,17764
1/26/2020,Q1,5,B,Hong Kong-Zhuhai-Macao Bridge,Departure,10182,3053,2082,15317
1/26/2020,Q1,5,B,Lok Ma Chau,Arrival,10754,3119,362,14235
1/26/2020,Q1,5,B,Lok Ma Chau,Departure,7058,3642,240,10940
1/26/2020,Q1,5,B,Man Kam To,Arrival,1093,345,24,1462
1/26/2020,Q1,5,B,Man Kam To,Departure,709,324,5,1038
1/26/2020,Q1,5,B,Sha Tau Kok,Arrival,2077,284,40,2401
1/26/2020,Q1,5,B,Sha Tau Kok,Departure,1058,312,48,1418
1/26/2020,Q1,5,B,Shenzhen Bay,Arrival,26235,6051,868,33154
1/26/2020,Q1,5,B,Shenzhen Bay,Departure,9524,7404,529,17457
1/26/2020,Q1,5,B,China Ferry Terminal,Arrival,2418,522,501,3441
1/26/2020,Q1,5,B,China Ferry Terminal,Departure,1391,603,504,2498
1/26/2020,Q1,5,B,Harbour Control,Arrival,0,0,256,256
1/26/2020,Q1,5,B,Harbour Control,Departure,0,0,0,0
1/26/2020,Q1,5,B,Kai Tak Cruise Terminal,Arrival,2510,806,2251,5567
1/26/2020,Q1,5,B,Kai Tak Cruise Terminal,Departure,1000,394,317,1711
1/26/2020,Q1,5,B,Macau Ferry Terminal,Arrival,8216,554,1325,10095
1/26/2020,Q1,5,B,Macau Ferry Terminal,Departure,6571,379,1284,8234
1/26/2020,Q1,5,B,Tuen Mun Ferry Terminal,Arrival,647,5,24,676
1/26/2020,Q1,5,B,Tuen Mun Ferry Terminal,Departure,605,7,28,640
1/27/2020,Q1,5,B,Airport,Arrival,36215,10309,6764,53288
1/27/2020,Q1,5,B,Airport,Departure,41316,8203,11319,60838
1/27/2020,Q1,5,B,Express Rail Link West Kowloon,Arrival,10913,1887,421,13221
1/27/2020,Q1,5,B,Express Rail Link West Kowloon,Departure,1167,2790,246,4203
1/27/2020,Q1,5,B,Hung Hom,Arrival,2025,221,116,2362
1/27/2020,Q1,5,B,Hung Hom,Departure,244,308,54,606
1/27/2020,Q1,5,B,Lo Wu,Arrival,43145,3643,387,47175
1/27/2020,Q1,5,B,Lo Wu,Departure,13999,5193,387,19579
1/27/2020,Q1,5,B,Lok Ma Chau Spur Line,Arrival,17463,2863,203,20529
1/27/2020,Q1,5,B,Lok Ma Chau Spur Line,Departure,7787,3592,175,11554
1/27/2020,Q1,5,B,Hong Kong-Zhuhai-Macao Bridge,Arrival,14306,1998,1998,18302
1/27/2020,Q1,5,B,Hong Kong-Zhuhai-Macao Bridge,Departure,7369,2822,2088,12279
1/27/2020,Q1,5,B,Lok Ma Chau,Arrival,10708,1945,356,13009
1/27/2020,Q1,5,B,Lok Ma Chau,Departure,5174,3655,233,9062
1/27/2020,Q1,5,B,Man Kam To,Arrival,1280,281,12,1573
1/27/2020,Q1,5,B,Man Kam To,Departure,569,324,5,898
1/27/2020,Q1,5,B,Sha Tau Kok,Arrival,2212,189,36,2437
1/27/2020,Q1,5,B,Sha Tau Kok,Departure,617,337,81,1035
1/27/2020,Q1,5,B,Shenzhen Bay,Arrival,27513,4507,759,32779
1/27/2020,Q1,5,B,Shenzhen Bay,Departure,5065,6538,598,12201
1/27/2020,Q1,5,B,China Ferry Terminal,Arrival,3124,477,431,4032
1/27/2020,Q1,5,B,China Ferry Terminal,Departure,944,530,411,1885
1/27/2020,Q1,5,B,Harbour Control,Arrival,69,0,32,101
1/27/2020,Q1,5,B,Harbour Control,Departure,28,0,25,53
1/27/2020,Q1,5,B,Kai Tak Cruise Terminal,Arrival,638,56,12,706
1/27/2020,Q1,5,B,Kai Tak Cruise Terminal,Departure,706,66,2190,2962
1/27/2020,Q1,5,B,Macau Ferry Terminal,Arrival,7258,394,1271,8923
1/27/2020,Q1,5,B,Macau Ferry Terminal,Departure,4981,343,1094,6418
1/27/2020,Q1,5,B,Tuen Mun Ferry Terminal,Arrival,601,10,18,629
1/27/2020,Q1,5,B,Tuen Mun Ferry Terminal,Departure,511,2,24,537
1/28/2020,Q1,5,B,Airport,Arrival,54491,7187,5422,67100
1/28/2020,Q1,5,B,Airport,Departure,41100,8306,12151,61557
1/28/2020,Q1,5,B,Express Rail Link West Kowloon,Arrival,13133,1828,322,15283
1/28/2020,Q1,5,B,Express Rail Link West Kowloon,Departure,864,2499,212,3575
1/28/2020,Q1,5,B,Hung Hom,Arrival,1754,194,64,2012
1/28/2020,Q1,5,B,Hung Hom,Departure,203,316,56,575
1/28/2020,Q1,5,B,Lo Wu,Arrival,39880,3633,381,43894
1/28/2020,Q1,5,B,Lo Wu,Departure,12598,4654,290,17542
1/28/2020,Q1,5,B,Lok Ma Chau Spur Line,Arrival,17313,2575,194,20082
1/28/2020,Q1,5,B,Lok Ma Chau Spur Line,Departure,7253,3018,175,10446
1/28/2020,Q1,5,B,Hong Kong-Zhuhai-Macao Bridge,Arrival,12420,1551,1534,15505
1/28/2020,Q1,5,B,Hong Kong-Zhuhai-Macao Bridge,Departure,5417,1795,1625,8837
1/28/2020,Q1,5,B,Lok Ma Chau,Arrival,10279,1831,329,12439
1/28/2020,Q1,5,B,Lok Ma Chau,Departure,4780,2722,202,7704
1/28/2020,Q1,5,B,Man Kam To,Arrival,1551,283,4,1838
1/28/2020,Q1,5,B,Man Kam To,Departure,582,269,3,854
1/28/2020,Q1,5,B,Sha Tau Kok,Arrival,2173,245,66,2484
1/28/2020,Q1,5,B,Sha Tau Kok,Departure,433,210,58,701
1/28/2020,Q1,5,B,Shenzhen Bay,Arrival,26094,4217,738,31049
1/28/2020,Q1,5,B,Shenzhen Bay,Departure,3797,5022,513,9332
1/28/2020,Q1,5,B,China Ferry Terminal,Arrival,2761,314,222,3297
1/28/2020,Q1,5,B,China Ferry Terminal,Departure,509,371,323,1203
1/28/2020,Q1,5,B,Harbour Control,Arrival,17,0,34,51
1/28/2020,Q1,5,B,Harbour Control,Departure,1,0,12,13
1/28/2020,Q1,5,B,Kai Tak Cruise Terminal,Arrival,705,56,8,769
1/28/2020,Q1,5,B,Kai Tak Cruise Terminal,Departure,427,75,6,508
1/28/2020,Q1,5,B,Macau Ferry Terminal,Arrival,5745,238,912,6895
1/28/2020,Q1,5,B,Macau Ferry Terminal,Departure,3634,288,864,4786
1/28/2020,Q1,5,B,Tuen Mun Ferry Terminal,Arrival,472,4,18,494
1/28/2020,Q1,5,B,Tuen Mun Ferry Terminal,Departure,306,1,27,334
1/29/2020,Q1,5,B,Airport,Arrival,50292,9196,5871,65359
1/29/2020,Q1,5,B,Airport,Departure,33880,7550,10514,51944
1/29/2020,Q1,5,B,Express Rail Link West Kowloon,Arrival,20022,1817,403,22242
1/29/2020,Q1,5,B,Express Rail Link West Kowloon,Departure,1195,3524,261,4980
1/29/2020,Q1,5,B,Hung Hom,Arrival,2038,201,87,2326
1/29/2020,Q1,5,B,Hung Hom,Departure,222,462,79,763
1/29/2020,Q1,5,B,Lo Wu,Arrival,44426,4343,485,49254
1/29/2020,Q1,5,B,Lo Wu,Departure,13519,5099,350,18968
1/29/2020,Q1,5,B,Lok Ma Chau Spur Line,Arrival,19574,3003,323,22900
1/29/2020,Q1,5,B,Lok Ma Chau Spur Line,Departure,8304,3414,245,11963
1/29/2020,Q1,5,B,Hong Kong-Zhuhai-Macao Bridge,Arrival,10793,1363,1168,13324
1/29/2020,Q1,5,B,Hong Kong-Zhuhai-Macao Bridge,Departure,4213,1588,1479,7280
1/29/2020,Q1,5,B,Lok Ma Chau,Arrival,11236,1900,385,13521
1/29/2020,Q1,5,B,Lok Ma Chau,Departure,5371,3111,252,8734
1/29/2020,Q1,5,B,Man Kam To,Arrival,1459,293,11,1763
1/29/2020,Q1,5,B,Man Kam To,Departure,629,308,10,947
1/29/2020,Q1,5,B,Sha Tau Kok,Arrival,2739,320,61,3120
1/29/2020,Q1,5,B,Sha Tau Kok,Departure,517,311,87,915
1/29/2020,Q1,5,B,Shenzhen Bay,Arrival,26892,4695,996,32583
1/29/2020,Q1,5,B,Shenzhen Bay,Departure,4398,6648,678,11724
1/29/2020,Q1,5,B,China Ferry Terminal,Arrival,3138,320,271,3729
1/29/2020,Q1,5,B,China Ferry Terminal,Departure,522,497,266,1285
1/29/2020,Q1,5,B,Harbour Control,Arrival,0,0,41,41
1/29/2020,Q1,5,B,Harbour Control,Departure,0,0,0,0
1/29/2020,Q1,5,B,Kai Tak Cruise Terminal,Arrival,427,75,10,512
1/29/2020,Q1,5,B,Kai Tak Cruise Terminal,Departure,372,49,21,442
1/29/2020,Q1,5,B,Macau Ferry Terminal,Arrival,4223,250,869,5342
1/29/2020,Q1,5,B,Macau Ferry Terminal,Departure,3211,223,877,4311
1/29/2020,Q1,5,B,Tuen Mun Ferry Terminal,Arrival,313,4,17,334
1/29/2020,Q1,5,B,Tuen Mun Ferry Terminal,Departure,293,1,24,318
1/30/2020,Q1,5,B,Airport,Arrival,46214,9907,5530,61651
1/30/2020,Q1,5,B,Airport,Departure,31072,7122,9882,48076
1/30/2020,Q1,5,B,Express Rail Link West Kowloon,Arrival,0,0,0,0
1/30/2020,Q1,5,B,Express Rail Link West Kowloon,Departure,0,0,0,0
1/30/2020,Q1,5,B,Hung Hom,Arrival,0,0,0,0
1/30/2020,Q1,5,B,Hung Hom,Departure,0,0,0,0
1/30/2020,Q1,5,B,Lo Wu,Arrival,30427,2470,308,33205
1/30/2020,Q1,5,B,Lo Wu,Departure,13178,3893,294,17365
1/30/2020,Q1,5,B,Lok Ma Chau Spur Line,Arrival,15978,1711,205,17894
1/30/2020,Q1,5,B,Lok Ma Chau Spur Line,Departure,8048,2570,168,10786
1/30/2020,Q1,5,B,Hong Kong-Zhuhai-Macao Bridge,Arrival,7032,946,923,8901
1/30/2020,Q1,5,B,Hong Kong-Zhuhai-Macao Bridge,Departure,3554,1360,1155,6069
1/30/2020,Q1,5,B,Lok Ma Chau,Arrival,9186,1430,312,10928
1/30/2020,Q1,5,B,Lok Ma Chau,Departure,4706,3386,322,8414
1/30/2020,Q1,5,B,Man Kam To,Arrival,0,0,0,0
1/30/2020,Q1,5,B,Man Kam To,Departure,0,0,0,0
1/30/2020,Q1,5,B,Sha Tau Kok,Arrival,0,0,0,0
1/30/2020,Q1,5,B,Sha Tau Kok,Departure,0,0,0,0
1/30/2020,Q1,5,B,Shenzhen Bay,Arrival,17109,2785,660,20554
1/30/2020,Q1,5,B,Shenzhen Bay,Departure,3707,6196,660,10563
1/30/2020,Q1,5,B,China Ferry Terminal,Arrival,0,0,0,0
1/30/2020,Q1,5,B,China Ferry Terminal,Departure,0,0,0,0
1/30/2020,Q1,5,B,Harbour Control,Arrival,1,0,69,70
1/30/2020,Q1,5,B,Harbour Control,Departure,0,0,22,22
1/30/2020,Q1,5,B,Kai Tak Cruise Terminal,Arrival,2921,134,161,3216
1/30/2020,Q1,5,B,Kai Tak Cruise Terminal,Departure,682,52,1761,2495
1/30/2020,Q1,5,B,Macau Ferry Terminal,Arrival,3638,172,694,4504
1/30/2020,Q1,5,B,Macau Ferry Terminal,Departure,3132,249,806,4187
1/30/2020,Q1,5,B,Tuen Mun Ferry Terminal,Arrival,0,0,0,0
1/30/2020,Q1,5,B,Tuen Mun Ferry Terminal,Departure,0,0,0,0
1/31/2020,Q1,5,B,Airport,Arrival,49093,7817,5089,61999
1/31/2020,Q1,5,B,Airport,Departure,28231,5737,7599,41567
1/31/2020,Q1,5,B,Express Rail Link West Kowloon,Arrival,0,0,0,0
1/31/2020,Q1,5,B,Express Rail Link West Kowloon,Departure,0,0,0,0
1/31/2020,Q1,5,B,Hung Hom,Arrival,0,0,0,0
1/31/2020,Q1,5,B,Hung Hom,Departure,0,0,0,0
1/31/2020,Q1,5,B,Lo Wu,Arrival,24064,1960,257,26281
1/31/2020,Q1,5,B,Lo Wu,Departure,13695,2845,267,16807
1/31/2020,Q1,5,B,Lok Ma Chau Spur Line,Arrival,14044,1518,181,15743
1/31/2020,Q1,5,B,Lok Ma Chau Spur Line,Departure,8490,1939,163,10592
1/31/2020,Q1,5,B,Hong Kong-Zhuhai-Macao Bridge,Arrival,5754,653,883,7290
1/31/2020,Q1,5,B,Hong Kong-Zhuhai-Macao Bridge,Departure,3626,897,1078,5601
1/31/2020,Q1,5,B,Lok Ma Chau,Arrival,7807,1200,225,9232
1/31/2020,Q1,5,B,Lok Ma Chau,Departure,4879,2598,302,7779
1/31/2020,Q1,5,B,Man Kam To,Arrival,0,0,0,0
1/31/2020,Q1,5,B,Man Kam To,Departure,0,0,0,0
1/31/2020,Q1,5,B,Sha Tau Kok,Arrival,0,0,0,0
1/31/2020,Q1,5,B,Sha Tau Kok,Departure,0,0,0,0
1/31/2020,Q1,5,B,Shenzhen Bay,Arrival,11541,2412,567,14520
1/31/2020,Q1,5,B,Shenzhen Bay,Departure,3727,4789,632,9148
1/31/2020,Q1,5,B,China Ferry Terminal,Arrival,0,0,0,0
1/31/2020,Q1,5,B,China Ferry Terminal,Departure,0,0,0,0
1/31/2020,Q1,5,B,Harbour Control,Arrival,2,0,330,332
1/31/2020,Q1,5,B,Harbour Control,Departure,2,0,9,11
1/31/2020,Q1,5,B,Kai Tak Cruise Terminal,Arrival,828,377,91,1296
1/31/2020,Q1,5,B,Kai Tak Cruise Terminal,Departure,1603,65,242,1910
1/31/2020,Q1,5,B,Macau Ferry Terminal,Arrival,3411,121,634,4166
1/31/2020,Q1,5,B,Macau Ferry Terminal,Departure,3253,124,660,4037
1/31/2020,Q1,5,B,Tuen Mun Ferry Terminal,Arrival,0,0,0,0
1/31/2020,Q1,5,B,Tuen Mun Ferry Terminal,Departure,0,0,0,0
2/1/2020,Q1,5,B,Airport,Arrival,55976,5703,4567,66246
2/1/2020,Q1,5,B,Airport,Departure,28798,5072,8046,41916
2/1/2020,Q1,5,B,Express Rail Link West Kowloon,Arrival,0,0,0,0
2/1/2020,Q1,5,B,Express Rail Link West Kowloon,Departure,0,0,0,0
2/1/2020,Q1,5,B,Hung Hom,Arrival,0,0,0,0
2/1/2020,Q1,5,B,Hung Hom,Departure,0,0,0,0
2/1/2020,Q1,5,B,Lo Wu,Arrival,21578,1883,276,23737
2/1/2020,Q1,5,B,Lo Wu,Departure,13759,2347,234,16340
2/1/2020,Q1,5,B,Lok Ma Chau Spur Line,Arrival,12975,1505,165,14645
2/1/2020,Q1,5,B,Lok Ma Chau Spur Line,Departure,8541,1805,139,10485
2/1/2020,Q1,5,B,Hong Kong-Zhuhai-Macao Bridge,Arrival,4926,632,1021,6579
2/1/2020,Q1,5,B,Hong Kong-Zhuhai-Macao Bridge,Departure,3259,784,1339,5382
2/1/2020,Q1,5,B,Lok Ma Chau,Arrival,6674,1134,236,8044
2/1/2020,Q1,5,B,Lok Ma Chau,Departure,4940,1855,179,6974
2/1/2020,Q1,5,B,Man Kam To,Arrival,0,0,0,0
2/1/2020,Q1,5,B,Man Kam To,Departure,0,0,0,0
2/1/2020,Q1,5,B,Sha Tau Kok,Arrival,0,0,0,0
2/1/2020,Q1,5,B,Sha Tau Kok,Departure,0,0,0,0
2/1/2020,Q1,5,B,Shenzhen Bay,Arrival,9788,2429,505,12722
2/1/2020,Q1,5,B,Shenzhen Bay,Departure,3378,3425,499,7302
2/1/2020,Q1,5,B,China Ferry Terminal,Arrival,0,0,0,0
2/1/2020,Q1,5,B,China Ferry Terminal,Departure,0,0,0,0
2/1/2020,Q1,5,B,Harbour Control,Arrival,0,0,60,60
2/1/2020,Q1,5,B,Harbour Control,Departure,0,0,5,5
2/1/2020,Q1,5,B,Kai Tak Cruise Terminal,Arrival,25,8,2334,2367
2/1/2020,Q1,5,B,Kai Tak Cruise Terminal,Departure,129,6,1965,2100
2/1/2020,Q1,5,B,Macau Ferry Terminal,Arrival,3180,88,596,3864
2/1/2020,Q1,5,B,Macau Ferry Terminal,Departure,3043,105,550,3698
2/1/2020,Q1,5,B,Tuen Mun Ferry Terminal,Arrival,0,0,0,0
2/1/2020,Q1,5,B,Tuen Mun Ferry Terminal,Departure,0,0,0,0
2/2/2020,Q1,5,B,Airport,Arrival,59083,4649,3762,67494
2/2/2020,Q1,5,B,Airport,Departure,25570,4360,6898,36828
2/2/2020,Q1,5,B,Express Rail Link West Kowloon,Arrival,0,0,0,0
2/2/2020,Q1,5,B,Express Rail Link West Kowloon,Departure,0,0,0,0
2/2/2020,Q1,5,B,Hung Hom,Arrival,0,0,0,0
2/2/2020,Q1,5,B,Hung Hom,Departure,0,0,0,0
2/2/2020,Q1,5,B,Lo Wu,Arrival,13138,1159,190,14487
2/2/2020,Q1,5,B,Lo Wu,Departure,6575,1392,151,8118
2/2/2020,Q1,5,B,Lok Ma Chau Spur Line,Arrival,17716,1739,177,19632
2/2/2020,Q1,5,B,Lok Ma Chau Spur Line,Departure,9832,2902,209,12943
2/2/2020,Q1,5,B,Hong Kong-Zhuhai-Macao Bridge,Arrival,5108,487,804,6399
2/2/2020,Q1,5,B,Hong Kong-Zhuhai-Macao Bridge,Departure,3165,649,1270,5084
2/2/2020,Q1,5,B,Lok Ma Chau,Arrival,10954,1272,254,12480
2/2/2020,Q1,5,B,Lok Ma Chau,Departure,4362,1820,234,6416
2/2/2020,Q1,5,B,Man Kam To,Arrival,0,0,0,0
2/2/2020,Q1,5,B,Man Kam To,Departure,0,0,0,0
2/2/2020,Q1,5,B,Sha Tau Kok,Arrival,0,0,0,0
2/2/2020,Q1,5,B,Sha Tau Kok,Departure,0,0,0,0
2/2/2020,Q1,5,B,Shenzhen Bay,Arrival,11706,2253,606,14565
2/2/2020,Q1,5,B,Shenzhen Bay,Departure,2968,3130,454,6552
2/2/2020,Q1,5,B,China Ferry Terminal,Arrival,0,0,0,0
2/2/2020,Q1,5,B,China Ferry Terminal,Departure,0,0,0,0
2/2/2020,Q1,5,B,Harbour Control,Arrival,0,0,184,184
2/2/2020,Q1,5,B,Harbour Control,Departure,0,0,0,0
2/2/2020,Q1,5,B,Kai Tak Cruise Terminal,Arrival,1637,58,53,1748
2/2/2020,Q1,5,B,Kai Tak Cruise Terminal,Departure,2172,22,241,2435
2/2/2020,Q1,5,B,Macau Ferry Terminal,Arrival,3057,98,369,3524
2/2/2020,Q1,5,B,Macau Ferry Terminal,Departure,2697,110,486,3293
2/2/2020,Q1,5,B,Tuen Mun Ferry Terminal,Arrival,0,0,0,0
2/2/2020,Q1,5,B,Tuen Mun Ferry Terminal,Departure,0,0,0,0
2/3/2020,Q1,5,B,Airport,Arrival,41208,6996,3846,52050
2/3/2020,Q1,5,B,Airport,Departure,21704,3596,5428,30728
2/3/2020,Q1,5,B,Express Rail Link West Kowloon,Arrival,0,0,0,0
2/3/2020,Q1,5,B,Express Rail Link West Kowloon,Departure,0,0,0,0
2/3/2020,Q1,5,B,Hung Hom,Arrival,0,0,0,0
2/3/2020,Q1,5,B,Hung Hom,Departure,0,0,0,0
2/3/2020,Q1,5,B,Lo Wu,Arrival,27196,1873,368,29437
2/3/2020,Q1,5,B,Lo Wu,Departure,14938,3078,320,18336
2/3/2020,Q1,5,B,Lok Ma Chau Spur Line,Arrival,17037,1038,242,18317
2/3/2020,Q1,5,B,Lok Ma Chau Spur Line,Departure,10113,1815,205,12133
2/3/2020,Q1,5,B,Hong Kong-Zhuhai-Macao Bridge,Arrival,3595,358,674,4627
2/3/2020,Q1,5,B,Hong Kong-Zhuhai-Macao Bridge,Departure,3023,723,849,4595
2/3/2020,Q1,5,B,Lok Ma Chau,Arrival,9823,1206,281,11310
2/3/2020,Q1,5,B,Lok Ma Chau,Departure,5461,2150,190,7801
2/3/2020,Q1,5,B,Man Kam To,Arrival,0,0,0,0
2/3/2020,Q1,5,B,Man Kam To,Departure,0,0,0,0
2/3/2020,Q1,5,B,Sha Tau Kok,Arrival,0,0,0,0
2/3/2020,Q1,5,B,Sha Tau Kok,Departure,0,0,0,0
2/3/2020,Q1,5,B,Shenzhen Bay,Arrival,8284,1871,504,10659
2/3/2020,Q1,5,B,Shenzhen Bay,Departure,3960,3754,486,8200
2/3/2020,Q1,5,B,China Ferry Terminal,Arrival,0,0,0,0
2/3/2020,Q1,5,B,China Ferry Terminal,Departure,0,0,0,0
2/3/2020,Q1,5,B,Harbour Control,Arrival,0,0,25,25
2/3/2020,Q1,5,B,Harbour Control,Departure,0,0,29,29
2/3/2020,Q1,5,B,Kai Tak Cruise Terminal,Arrival,330,22,6,358
2/3/2020,Q1,5,B,Kai Tak Cruise Terminal,Departure,203,21,4,228
2/3/2020,Q1,5,B,Macau Ferry Terminal,Arrival,3560,97,564,4221
2/3/2020,Q1,5,B,Macau Ferry Terminal,Departure,3333,109,589,4031
2/3/2020,Q1,5,B,Tuen Mun Ferry Terminal,Arrival,0,0,0,0
2/3/2020,Q1,5,B,Tuen Mun Ferry Terminal,Departure,0,0,0,0
2/4/2020,Q1,5,B,Airport,Arrival,31173,6317,3647,41137
2/4/2020,Q1,5,B,Airport,Departure,20187,3550,4471,28208
2/4/2020,Q1,5,B,Express Rail Link West Kowloon,Arrival,0,0,0,0
2/4/2020,Q1,5,B,Express Rail Link West Kowloon,Departure,0,0,0,0
2/4/2020,Q1,5,B,Hung Hom,Arrival,0,0,0,0
2/4/2020,Q1,5,B,Hung Hom,Departure,0,0,0,0
2/4/2020,Q1,5,B,Lo Wu,Arrival,0,0,0,0
2/4/2020,Q1,5,B,Lo Wu,Departure,0,0,0,0
2/4/2020,Q1,5,B,Lok Ma Chau Spur Line,Arrival,0,0,0,0
2/4/2020,Q1,5,B,Lok Ma Chau Spur Line,Departure,0,0,0,0
2/4/2020,Q1,5,B,Hong Kong-Zhuhai-Macao Bridge,Arrival,4555,402,1020,5977
2/4/2020,Q1,5,B,Hong Kong-Zhuhai-Macao Bridge,Departure,3177,985,1020,5182
2/4/2020,Q1,5,B,Lok Ma Chau,Arrival,0,0,0,0
2/4/2020,Q1,5,B,Lok Ma Chau,Departure,0,0,0,0
2/4/2020,Q1,5,B,Man Kam To,Arrival,0,0,0,0
2/4/2020,Q1,5,B,Man Kam To,Departure,0,0,0,0
2/4/2020,Q1,5,B,Sha Tau Kok,Arrival,0,0,0,0
2/4/2020,Q1,5,B,Sha Tau Kok,Departure,0,0,0,0
2/4/2020,Q1,5,B,Shenzhen Bay,Arrival,18852,2771,786,22409
2/4/2020,Q1,5,B,Shenzhen Bay,Departure,10838,6731,809,18378
2/4/2020,Q1,5,B,China Ferry Terminal,Arrival,0,0,0,0
2/4/2020,Q1,5,B,China Ferry Terminal,Departure,0,0,0,0
2/4/2020,Q1,5,B,Harbour Control,Arrival,33,0,30,63
2/4/2020,Q1,5,B,Harbour Control,Departure,30,0,33,63
2/4/2020,Q1,5,B,Kai Tak Cruise Terminal,Arrival,203,21,2,226
2/4/2020,Q1,5,B,Kai Tak Cruise Terminal,Departure,173,10,2,185
2/4/2020,Q1,5,B,Macau Ferry Terminal,Arrival,0,0,0,0
2/4/2020,Q1,5,B,Macau Ferry Terminal,Departure,0,0,0,0
2/4/2020,Q1,5,B,Tuen Mun Ferry Terminal,Arrival,0,0,0,0
2/4/2020,Q1,5,B,Tuen Mun Ferry Terminal,Departure,0,0,0,0
2/5/2020,Q1,5,B,Airport,Arrival,24832,6041,3592,34465
2/5/2020,Q1,5,B,Airport,Departure,22297,2591,4404,29292
2/5/2020,Q1,5,B,Express Rail Link West Kowloon,Arrival,0,0,0,0
2/5/2020,Q1,5,B,Express Rail Link West Kowloon,Departure,0,0,0,0
2/5/2020,Q1,5,B,Hung Hom,Arrival,0,0,0,0
2/5/2020,Q1,5,B,Hung Hom,Departure,0,0,0,0
2/5/2020,Q1,5,B,Lo Wu,Arrival,0,0,0,0
2/5/2020,Q1,5,B,Lo Wu,Departure,0,0,0,0
2/5/2020,Q1,5,B,Lok Ma Chau Spur Line,Arrival,0,0,0,0
2/5/2020,Q1,5,B,Lok Ma Chau Spur Line,Departure,0,0,0,0
2/5/2020,Q1,5,B,Hong Kong-Zhuhai-Macao Bridge,Arrival,3172,329,1121,4622
2/5/2020,Q1,5,B,Hong Kong-Zhuhai-Macao Bridge,Departure,2025,925,885,3835
2/5/2020,Q1,5,B,Lok Ma Chau,Arrival,0,0,0,0
2/5/2020,Q1,5,B,Lok Ma Chau,Departure,0,0,0,0
2/5/2020,Q1,5,B,Man Kam To,Arrival,0,0,0,0
2/5/2020,Q1,5,B,Man Kam To,Departure,0,0,0,0
2/5/2020,Q1,5,B,Sha Tau Kok,Arrival,0,0,0,0
2/5/2020,Q1,5,B,Sha Tau Kok,Departure,0,0,0,0
2/5/2020,Q1,5,B,Shenzhen Bay,Arrival,16387,2378,714,19479
2/5/2020,Q1,5,B,Shenzhen Bay,Departure,11893,6359,837,19089
2/5/2020,Q1,5,B,China Ferry Terminal,Arrival,0,0,0,0
2/5/2020,Q1,5,B,China Ferry Terminal,Departure,0,0,0,0
2/5/2020,Q1,5,B,Harbour Control,Arrival,0,0,0,0
2/5/2020,Q1,5,B,Harbour Control,Departure,0,0,0,0
2/5/2020,Q1,5,B,Kai Tak Cruise Terminal,Arrival,175,12,31,218
2/5/2020,Q1,5,B,Kai Tak Cruise Terminal,Departure,2,2,0,4
2/5/2020,Q1,5,B,Macau Ferry Terminal,Arrival,0,0,0,0
2/5/2020,Q1,5,B,Macau Ferry Terminal,Departure,0,0,0,0
2/5/2020,Q1,5,B,Tuen Mun Ferry Terminal,Arrival,0,0,0,0
2/5/2020,Q1,5,B,Tuen Mun Ferry Terminal,Departure,0,0,0,0
2/6/2020,Q1,5,B,Airport,Arrival,21261,5728,3478,30467
2/6/2020,Q1,5,B,Airport,Departure,22252,2512,4222,28986
2/6/2020,Q1,5,B,Express Rail Link West Kowloon,Arrival,0,0,0,0
2/6/2020,Q1,5,B,Express Rail Link West Kowloon,Departure,0,0,0,0
2/6/2020,Q1,5,B,Hung Hom,Arrival,0,0,0,0
2/6/2020,Q1,5,B,Hung Hom,Departure,0,0,0,0
2/6/2020,Q1,5,B,Lo Wu,Arrival,0,0,0,0
2/6/2020,Q1,5,B,Lo Wu,Departure,0,0,0,0
2/6/2020,Q1,5,B,Lok Ma Chau Spur Line,Arrival,0,0,0,0
2/6/2020,Q1,5,B,Lok Ma Chau Spur Line,Departure,0,0,0,0
2/6/2020,Q1,5,B,Hong Kong-Zhuhai-Macao Bridge,Arrival,4941,468,1188,6597
2/6/2020,Q1,5,B,Hong Kong-Zhuhai-Macao Bridge,Departure,2608,1068,834,4510
2/6/2020,Q1,5,B,Lok Ma Chau,Arrival,0,0,0,0
2/6/2020,Q1,5,B,Lok Ma Chau,Departure,0,0,0,0
2/6/2020,Q1,5,B,Man Kam To,Arrival,0,0,0,0
2/6/2020,Q1,5,B,Man Kam To,Departure,0,0,0,0
2/6/2020,Q1,5,B,Sha Tau Kok,Arrival,0,0,0,0
2/6/2020,Q1,5,B,Sha Tau Kok,Departure,0,0,0,0
2/6/2020,Q1,5,B,Shenzhen Bay,Arrival,38920,4813,1220,44953
2/6/2020,Q1,5,B,Shenzhen Bay,Departure,21360,7071,1197,29628
2/6/2020,Q1,5,B,China Ferry Terminal,Arrival,0,0,0,0
2/6/2020,Q1,5,B,China Ferry Terminal,Departure,0,0,0,0
2/6/2020,Q1,5,B,Harbour Control,Arrival,0,0,0,0
2/6/2020,Q1,5,B,Harbour Control,Departure,0,0,0,0
2/6/2020,Q1,5,B,Kai Tak Cruise Terminal,Arrival,0,0,0,0
2/6/2020,Q1,5,B,Kai Tak Cruise Terminal,Departure,0,0,0,0
2/6/2020,Q1,5,B,Macau Ferry Terminal,Arrival,0,0,0,0
2/6/2020,Q1,5,B,Macau Ferry Terminal,Departure,0,0,0,0
2/6/2020,Q1,5,B,Tuen Mun Ferry Terminal,Arrival,0,0,0,0
2/6/2020,Q1,5,B,Tuen Mun Ferry Terminal,Departure,0,0,0,0
2/7/2020,Q1,5,B,Airport,Arrival,19694,5563,3556,28813
2/7/2020,Q1,5,B,Airport,Departure,21417,2735,4012,28164
2/7/2020,Q1,5,B,Express Rail Link West Kowloon,Arrival,0,0,0,0
2/7/2020,Q1,5,B,Express Rail Link West Kowloon,Departure,0,0,0,0
2/7/2020,Q1,5,B,Hung Hom,Arrival,0,0,0,0
2/7/2020,Q1,5,B,Hung Hom,Departure,0,0,0,0
2/7/2020,Q1,5,B,Lo Wu,Arrival,0,0,0,0
2/7/2020,Q1,5,B,Lo Wu,Departure,0,0,0,0
2/7/2020,Q1,5,B,Lok Ma Chau Spur Line,Arrival,0,0,0,0
2/7/2020,Q1,5,B,Lok Ma Chau Spur Line,Departure,0,0,0,0
2/7/2020,Q1,5,B,Hong Kong-Zhuhai-Macao Bridge,Arrival,6699,628,1340,8667
2/7/2020,Q1,5,B,Hong Kong-Zhuhai-Macao Bridge,Departure,2576,1102,798,4476
2/7/2020,Q1,5,B,Lok Ma Chau,Arrival,0,0,0,0
2/7/2020,Q1,5,B,Lok Ma Chau,Departure,0,0,0,0
2/7/2020,Q1,5,B,Man Kam To,Arrival,0,0,0,0
2/7/2020,Q1,5,B,Man Kam To,Departure,0,0,0,0
2/7/2020,Q1,5,B,Sha Tau Kok,Arrival,0,0,0,0
2/7/2020,Q1,5,B,Sha Tau Kok,Departure,0,0,0,0
2/7/2020,Q1,5,B,Shenzhen Bay,Arrival,50506,6555,1441,58502
2/7/2020,Q1,5,B,Shenzhen Bay,Departure,16746,7282,1320,25348
2/7/2020,Q1,5,B,China Ferry Terminal,Arrival,0,0,0,0
2/7/2020,Q1,5,B,China Ferry Terminal,Departure,0,0,0,0
2/7/2020,Q1,5,B,Harbour Control,Arrival,0,0,0,0
2/7/2020,Q1,5,B,Harbour Control,Departure,0,0,0,0
2/7/2020,Q1,5,B,Kai Tak Cruise Terminal,Arrival,0,0,0,0
2/7/2020,Q1,5,B,Kai Tak Cruise Terminal,Departure,0,0,0,0
2/7/2020,Q1,5,B,Macau Ferry Terminal,Arrival,0,0,0,0
2/7/2020,Q1,5,B,Macau Ferry Terminal,Departure,0,0,0,0
2/7/2020,Q1,5,B,Tuen Mun Ferry Terminal,Arrival,0,0,0,0
2/7/2020,Q1,5,B,Tuen Mun Ferry Terminal,Departure,0,0,0,0
2/8/2020,Q1,5,B,Airport,Arrival,17956,943,3070,21969
2/8/2020,Q1,5,B,Airport,Departure,20163,1127,3253,24543
2/8/2020,Q1,5,B,Express Rail Link West Kowloon,Arrival,0,0,0,0
2/8/2020,Q1,5,B,Express Rail Link West Kowloon,Departure,0,0,0,0
2/8/2020,Q1,5,B,Hung Hom,Arrival,0,0,0,0
2/8/2020,Q1,5,B,Hung Hom,Departure,0,0,0,0
2/8/2020,Q1,5,B,Lo Wu,Arrival,0,0,0,0
2/8/2020,Q1,5,B,Lo Wu,Departure,0,0,0,0
2/8/2020,Q1,5,B,Lok Ma Chau Spur Line,Arrival,0,0,0,0
2/8/2020,Q1,5,B,Lok Ma Chau Spur Line,Departure,0,0,0,0
2/8/2020,Q1,5,B,Hong Kong-Zhuhai-Macao Bridge,Arrival,659,9,508,1176
2/8/2020,Q1,5,B,Hong Kong-Zhuhai-Macao Bridge,Departure,750,163,442,1355
2/8/2020,Q1,5,B,Lok Ma Chau,Arrival,0,0,0,0
2/8/2020,Q1,5,B,Lok Ma Chau,Departure,0,0,0,0
2/8/2020,Q1,5,B,Man Kam To,Arrival,0,0,0,0
2/8/2020,Q1,5,B,Man Kam To,Departure,0,0,0,0
2/8/2020,Q1,5,B,Sha Tau Kok,Arrival,0,0,0,0
2/8/2020,Q1,5,B,Sha Tau Kok,Departure,0,0,0,0
2/8/2020,Q1,5,B,Shenzhen Bay,Arrival,208,43,3,254
2/8/2020,Q1,5,B,Shenzhen Bay,Departure,1291,1351,549,3191
2/8/2020,Q1,5,B,China Ferry Terminal,Arrival,0,0,0,0
2/8/2020,Q1,5,B,China Ferry Terminal,Departure,0,0,0,0
2/8/2020,Q1,5,B,Harbour Control,Arrival,0,0,0,0
2/8/2020,Q1,5,B,Harbour Control,Departure,0,0,0,0
2/8/2020,Q1,5,B,Kai Tak Cruise Terminal,Arrival,0,0,0,0
2/8/2020,Q1,5,B,Kai Tak Cruise Terminal,Departure,0,0,0,0
2/8/2020,Q1,5,B,Macau Ferry Terminal,Arrival,0,0,0,0
2/8/2020,Q1,5,B,Macau Ferry Terminal,Departure,0,0,0,0
2/8/2020,Q1,5,B,Tuen Mun Ferry Terminal,Arrival,0,0,0,0
2/8/2020,Q1,5,B,Tuen Mun Ferry Terminal,Departure,0,0,0,0
2/9/2020,Q1,5,B,Airport,Arrival,22077,913,2591,25581
2/9/2020,Q1,5,B,Airport,Departure,17782,971,3200,21953
2/9/2020,Q1,5,B,Express Rail Link West Kowloon,Arrival,0,0,0,0
2/9/2020,Q1,5,B,Express Rail Link West Kowloon,Departure,0,0,0,0
2/9/2020,Q1,5,B,Hung Hom,Arrival,0,0,0,0
2/9/2020,Q1,5,B,Hung Hom,Departure,0,0,0,0
2/9/2020,Q1,5,B,Lo Wu,Arrival,0,0,0,0
2/9/2020,Q1,5,B,Lo Wu,Departure,0,0,0,0
2/9/2020,Q1,5,B,Lok Ma Chau Spur Line,Arrival,0,0,0,0
2/9/2020,Q1,5,B,Lok Ma Chau Spur Line,Departure,0,0,0,0
2/9/2020,Q1,5,B,Hong Kong-Zhuhai-Macao Bridge,Arrival,710,7,493,1210
2/9/2020,Q1,5,B,Hong Kong-Zhuhai-Macao Bridge,Departure,1185,167,524,1876
2/9/2020,Q1,5,B,Lok Ma Chau,Arrival,0,0,0,0
2/9/2020,Q1,5,B,Lok Ma Chau,Departure,0,0,0,0
2/9/2020,Q1,5,B,Man Kam To,Arrival,0,0,0,0
2/9/2020,Q1,5,B,Man Kam To,Departure,0,0,0,0
2/9/2020,Q1,5,B,Sha Tau Kok,Arrival,0,0,0,0
2/9/2020,Q1,5,B,Sha Tau Kok,Departure,0,0,0,0
2/9/2020,Q1,5,B,Shenzhen Bay,Arrival,314,36,3,353
2/9/2020,Q1,5,B,Shenzhen Bay,Departure,1802,1303,573,3678
2/9/2020,Q1,5,B,China Ferry Terminal,Arrival,0,0,0,0
2/9/2020,Q1,5,B,China Ferry Terminal,Departure,0,0,0,0
2/9/2020,Q1,5,B,Harbour Control,Arrival,0,0,0,0
2/9/2020,Q1,5,B,Harbour Control,Departure,0,0,0,0
2/9/2020,Q1,5,B,Kai Tak Cruise Terminal,Arrival,1838,0,33,1871
2/9/2020,Q1,5,B,Kai Tak Cruise Terminal,Departure,0,0,0,0
2/9/2020,Q1,5,B,Macau Ferry Terminal,Arrival,0,0,0,0
2/9/2020,Q1,5,B,Macau Ferry Terminal,Departure,0,0,0,0
2/9/2020,Q1,5,B,Tuen Mun Ferry Terminal,Arrival,0,0,0,0
2/9/2020,Q1,5,B,Tuen Mun Ferry Terminal,Departure,0,0,0,0
2/10/2020,Q1,5,B,Airport,Arrival,17139,766,2037,19942
2/10/2020,Q1,5,B,Airport,Departure,15550,535,3219,19304
2/10/2020,Q1,5,B,Express Rail Link West Kowloon,Arrival,0,0,0,0
2/10/2020,Q1,5,B,Express Rail Link West Kowloon,Departure,0,0,0,0
2/10/2020,Q1,5,B,Hung Hom,Arrival,0,0,0,0
2/10/2020,Q1,5,B,Hung Hom,Departure,0,0,0,0
2/10/2020,Q1,5,B,Lo Wu,Arrival,0,0,0,0
2/10/2020,Q1,5,B,Lo Wu,Departure,0,0,0,0
2/10/2020,Q1,5,B,Lok Ma Chau Spur Line,Arrival,0,0,0,0
2/10/2020,Q1,5,B,Lok Ma Chau Spur Line,Departure,0,0,0,0
2/10/2020,Q1,5,B,Hong Kong-Zhuhai-Macao Bridge,Arrival,808,10,496,1314
2/10/2020,Q1,5,B,Hong Kong-Zhuhai-Macao Bridge,Departure,1508,137,444,2089
2/10/2020,Q1,5,B,Lok Ma Chau,Arrival,0,0,0,0
2/10/2020,Q1,5,B,Lok Ma Chau,Departure,0,0,0,0
2/10/2020,Q1,5,B,Man Kam To,Arrival,0,0,0,0
2/10/2020,Q1,5,B,Man Kam To,Departure,0,0,0,0
2/10/2020,Q1,5,B,Sha Tau Kok,Arrival,0,0,0,0
2/10/2020,Q1,5,B,Sha Tau Kok,Departure,0,0,0,0
2/10/2020,Q1,5,B,Shenzhen Bay,Arrival,461,56,4,521
2/10/2020,Q1,5,B,Shenzhen Bay,Departure,1835,1016,185,3036
2/10/2020,Q1,5,B,China Ferry Terminal,Arrival,0,0,0,0
2/10/2020,Q1,5,B,China Ferry Terminal,Departure,0,0,0,0
2/10/2020,Q1,5,B,Harbour Control,Arrival,0,0,0,0
2/10/2020,Q1,5,B,Harbour Control,Departure,0,0,0,0
2/10/2020,Q1,5,B,Kai Tak Cruise Terminal,Arrival,0,0,0,0
2/10/2020,Q1,5,B,Kai Tak Cruise Terminal,Departure,0,0,0,0
2/10/2020,Q1,5,B,Macau Ferry Terminal,Arrival,0,0,0,0
2/10/2020,Q1,5,B,Macau Ferry Terminal,Departure,0,0,0,0
2/10/2020,Q1,5,B,Tuen Mun Ferry Terminal,Arrival,0,0,0,0
2/10/2020,Q1,5,B,Tuen Mun Ferry Terminal,Departure,0,0,0,0
2/11/2020,Q1,5,B,Airport,Arrival,14663,647,2107,17417
2/11/2020,Q1,5,B,Airport,Departure,12645,481,2556,15682
2/11/2020,Q1,5,B,Express Rail Link West Kowloon,Arrival,0,0,0,0
2/11/2020,Q1,5,B,Express Rail Link West Kowloon,Departure,0,0,0,0
2/11/2020,Q1,5,B,Hung Hom,Arrival,0,0,0,0
2/11/2020,Q1,5,B,Hung Hom,Departure,0,0,0,0
2/11/2020,Q1,5,B,Lo Wu,Arrival,0,0,0,0
2/11/2020,Q1,5,B,Lo Wu,Departure,0,0,0,0
2/11/2020,Q1,5,B,Lok Ma Chau Spur Line,Arrival,0,0,0,0
2/11/2020,Q1,5,B,Lok Ma Chau Spur Line,Departure,0,0,0,0
2/11/2020,Q1,5,B,Hong Kong-Zhuhai-Macao Bridge,Arrival,729,11,458,1198
2/11/2020,Q1,5,B,Hong Kong-Zhuhai-Macao Bridge,Departure,960,103,452,1515
2/11/2020,Q1,5,B,Lok Ma Chau,Arrival,0,0,0,0
2/11/2020,Q1,5,B,Lok Ma Chau,Departure,0,0,0,0
2/11/2020,Q1,5,B,Man Kam To,Arrival,0,0,0,0
2/11/2020,Q1,5,B,Man Kam To,Departure,0,0,0,0
2/11/2020,Q1,5,B,Sha Tau Kok,Arrival,0,0,0,0
2/11/2020,Q1,5,B,Sha Tau Kok,Departure,0,0,0,0
2/11/2020,Q1,5,B,Shenzhen Bay,Arrival,561,80,4,645
2/11/2020,Q1,5,B,Shenzhen Bay,Departure,1105,739,140,1984
2/11/2020,Q1,5,B,China Ferry Terminal,Arrival,0,0,0,0
2/11/2020,Q1,5,B,China Ferry Terminal,Departure,0,0,0,0
2/11/2020,Q1,5,B,Harbour Control,Arrival,0,0,0,0
2/11/2020,Q1,5,B,Harbour Control,Departure,0,0,0,0
2/11/2020,Q1,5,B,Kai Tak Cruise Terminal,Arrival,0,0,0,0
2/11/2020,Q1,5,B,Kai Tak Cruise Terminal,Departure,0,0,0,0
2/11/2020,Q1,5,B,Macau Ferry Terminal,Arrival,0,0,0,0
2/11/2020,Q1,5,B,Macau Ferry Terminal,Departure,0,0,0,0
2/11/2020,Q1,5,B,Tuen Mun Ferry Terminal,Arrival,0,0,0,0
2/11/2020,Q1,5,B,Tuen Mun Ferry Terminal,Departure,0,0,0,0
2/12/2020,Q1,5,B,Airport,Arrival,14221,619,1725,16565
2/12/2020,Q1,5,B,Airport,Departure,13637,471,2358,16466
2/12/2020,Q1,5,B,Express Rail Link West Kowloon,Arrival,0,0,0,0
2/12/2020,Q1,5,B,Express Rail Link West Kowloon,Departure,0,0,0,0
2/12/2020,Q1,5,B,Hung Hom,Arrival,0,0,0,0
2/12/2020,Q1,5,B,Hung Hom,Departure,0,0,0,0
2/12/2020,Q1,5,B,Lo Wu,Arrival,0,0,0,0
2/12/2020,Q1,5,B,Lo Wu,Departure,0,0,0,0
2/12/2020,Q1,5,B,Lok Ma Chau Spur Line,Arrival,0,0,0,0
2/12/2020,Q1,5,B,Lok Ma Chau Spur Line,Departure,0,0,0,0
2/12/2020,Q1,5,B,Hong Kong-Zhuhai-Macao Bridge,Arrival,862,4,449,1315
2/12/2020,Q1,5,B,Hong Kong-Zhuhai-Macao Bridge,Departure,904,109,350,1363
2/12/2020,Q1,5,B,Lok Ma Chau,Arrival,0,0,0,0
2/12/2020,Q1,5,B,Lok Ma Chau,Departure,0,0,0,0
2/12/2020,Q1,5,B,Man Kam To,Arrival,0,0,0,0
2/12/2020,Q1,5,B,Man Kam To,Departure,0,0,0,0
2/12/2020,Q1,5,B,Sha Tau Kok,Arrival,0,0,0,0
2/12/2020,Q1,5,B,Sha Tau Kok,Departure,0,0,0,0
2/12/2020,Q1,5,B,Shenzhen Bay,Arrival,709,106,2,817
2/12/2020,Q1,5,B,Shenzhen Bay,Departure,1219,862,114,2195
2/12/2020,Q1,5,B,China Ferry Terminal,Arrival,0,0,0,0
2/12/2020,Q1,5,B,China Ferry Terminal,Departure,0,0,0,0
2/12/2020,Q1,5,B,Harbour Control,Arrival,0,0,0,0
2/12/2020,Q1,5,B,Harbour Control,Departure,0,0,0,0
2/12/2020,Q1,5,B,Kai Tak Cruise Terminal,Arrival,0,0,0,0
2/12/2020,Q1,5,B,Kai Tak Cruise Terminal,Departure,0,0,0,0
2/12/2020,Q1,5,B,Macau Ferry Terminal,Arrival,0,0,0,0
2/12/2020,Q1,5,B,Macau Ferry Terminal,Departure,0,0,0,0
2/12/2020,Q1,5,B,Tuen Mun Ferry Terminal,Arrival,0,0,0,0
2/12/2020,Q1,5,B,Tuen Mun Ferry Terminal,Departure,0,0,0,0
2/13/2020,Q1,5,B,Airport,Arrival,11620,638,1938,14196
2/13/2020,Q1,5,B,Airport,Departure,15259,453,2150,17862
2/13/2020,Q1,5,B,Express Rail Link West Kowloon,Arrival,0,0,0,0
2/13/2020,Q1,5,B,Express Rail Link West Kowloon,Departure,0,0,0,0
2/13/2020,Q1,5,B,Hung Hom,Arrival,0,0,0,0
2/13/2020,Q1,5,B,Hung Hom,Departure,0,0,0,0
2/13/2020,Q1,5,B,Lo Wu,Arrival,0,0,0,0
2/13/2020,Q1,5,B,Lo Wu,Departure,0,0,0,0
2/13/2020,Q1,5,B,Lok Ma Chau Spur Line,Arrival,0,0,0,0
2/13/2020,Q1,5,B,Lok Ma Chau Spur Line,Departure,0,0,0,0
2/13/2020,Q1,5,B,Hong Kong-Zhuhai-Macao Bridge,Arrival,936,8,503,1447
2/13/2020,Q1,5,B,Hong Kong-Zhuhai-Macao Bridge,Departure,1089,124,450,1663
2/13/2020,Q1,5,B,Lok Ma Chau,Arrival,0,0,0,0
2/13/2020,Q1,5,B,Lok Ma Chau,Departure,0,0,0,0
2/13/2020,Q1,5,B,Man Kam To,Arrival,0,0,0,0
2/13/2020,Q1,5,B,Man Kam To,Departure,0,0,0,0
2/13/2020,Q1,5,B,Sha Tau Kok,Arrival,0,0,0,0
2/13/2020,Q1,5,B,Sha Tau Kok,Departure,0,0,0,0
2/13/2020,Q1,5,B,Shenzhen Bay,Arrival,756,105,17,878
2/13/2020,Q1,5,B,Shenzhen Bay,Departure,1056,856,104,2016
2/13/2020,Q1,5,B,China Ferry Terminal,Arrival,0,0,0,0
2/13/2020,Q1,5,B,China Ferry Terminal,Departure,0,0,0,0
2/13/2020,Q1,5,B,Harbour Control,Arrival,0,0,0,0
2/13/2020,Q1,5,B,Harbour Control,Departure,0,0,0,0
2/13/2020,Q1,5,B,Kai Tak Cruise Terminal,Arrival,0,0,0,0
2/13/2020,Q1,5,B,Kai Tak Cruise Terminal,Departure,0,0,0,0
2/13/2020,Q1,5,B,Macau Ferry Terminal,Arrival,0,0,0,0
2/13/2020,Q1,5,B,Macau Ferry Terminal,Departure,0,0,0,0
2/13/2020,Q1,5,B,Tuen Mun Ferry Terminal,Arrival,0,0,0,0
2/13/2020,Q1,5,B,Tuen Mun Ferry Terminal,Departure,0,0,0,0
2/14/2020,Q1,5,B,Airport,Arrival,11246,584,2015,13845
2/14/2020,Q1,5,B,Airport,Departure,15770,477,2012,18259
2/14/2020,Q1,5,B,Express Rail Link West Kowloon,Arrival,0,0,0,0
2/14/2020,Q1,5,B,Express Rail Link West Kowloon,Departure,0,0,0,0
2/14/2020,Q1,5,B,Hung Hom,Arrival,0,0,0,0
2/14/2020,Q1,5,B,Hung Hom,Departure,0,0,0,0
2/14/2020,Q1,5,B,Lo Wu,Arrival,0,0,0,0
2/14/2020,Q1,5,B,Lo Wu,Departure,0,0,0,0
2/14/2020,Q1,5,B,Lok Ma Chau Spur Line,Arrival,0,0,0,0
2/14/2020,Q1,5,B,Lok Ma Chau Spur Line,Departure,0,0,0,0
2/14/2020,Q1,5,B,Hong Kong-Zhuhai-Macao Bridge,Arrival,1491,5,553,2049
2/14/2020,Q1,5,B,Hong Kong-Zhuhai-Macao Bridge,Departure,1298,110,447,1855
2/14/2020,Q1,5,B,Lok Ma Chau,Arrival,0,0,0,0
2/14/2020,Q1,5,B,Lok Ma Chau,Departure,0,0,0,0
2/14/2020,Q1,5,B,Man Kam To,Arrival,0,0,0,0
2/14/2020,Q1,5,B,Man Kam To,Departure,0,0,0,0
2/14/2020,Q1,5,B,Sha Tau Kok,Arrival,0,0,0,0
2/14/2020,Q1,5,B,Sha Tau Kok,Departure,0,0,0,0
2/14/2020,Q1,5,B,Shenzhen Bay,Arrival,770,94,6,870
2/14/2020,Q1,5,B,Shenzhen Bay,Departure,1092,1016,117,2225
2/14/2020,Q1,5,B,China Ferry Terminal,Arrival,0,0,0,0
2/14/2020,Q1,5,B,China Ferry Terminal,Departure,0,0,0,0
2/14/2020,Q1,5,B,Harbour Control,Arrival,0,0,0,0
2/14/2020,Q1,5,B,Harbour Control,Departure,0,0,0,0
2/14/2020,Q1,5,B,Kai Tak Cruise Terminal,Arrival,0,0,0,0
2/14/2020,Q1,5,B,Kai Tak Cruise Terminal,Departure,0,0,0,0
2/14/2020,Q1,5,B,Macau Ferry Terminal,Arrival,0,0,0,0
2/14/2020,Q1,5,B,Macau Ferry Terminal,Departure,0,0,0,0
2/14/2020,Q1,5,B,Tuen Mun Ferry Terminal,Arrival,0,0,0,0
2/14/2020,Q1,5,B,Tuen Mun Ferry Terminal,Departure,0,0,0,0
2/15/2020,Q1,5,B,Airport,Arrival,14097,692,2098,16887
2/15/2020,Q1,5,B,Airport,Departure,14575,390,2064,17029
2/15/2020,Q1,5,B,Express Rail Link West Kowloon,Arrival,0,0,0,0
2/15/2020,Q1,5,B,Express Rail Link West Kowloon,Departure,0,0,0,0
2/15/2020,Q1,5,B,Hung Hom,Arrival,0,0,0,0
2/15/2020,Q1,5,B,Hung Hom,Departure,0,0,0,0
2/15/2020,Q1,5,B,Lo Wu,Arrival,0,0,0,0
2/15/2020,Q1,5,B,Lo Wu,Departure,0,0,0,0
2/15/2020,Q1,5,B,Lok Ma Chau Spur Line,Arrival,0,0,0,0
2/15/2020,Q1,5,B,Lok Ma Chau Spur Line,Departure,0,0,0,0
2/15/2020,Q1,5,B,Hong Kong-Zhuhai-Macao Bridge,Arrival,1183,5,524,1712
2/15/2020,Q1,5,B,Hong Kong-Zhuhai-Macao Bridge,Departure,1060,119,486,1665
2/15/2020,Q1,5,B,Lok Ma Chau,Arrival,0,0,0,0
2/15/2020,Q1,5,B,Lok Ma Chau,Departure,0,0,0,0
2/15/2020,Q1,5,B,Man Kam To,Arrival,0,0,0,0
2/15/2020,Q1,5,B,Man Kam To,Departure,0,0,0,0
2/15/2020,Q1,5,B,Sha Tau Kok,Arrival,0,0,0,0
2/15/2020,Q1,5,B,Sha Tau Kok,Departure,0,0,0,0
2/15/2020,Q1,5,B,Shenzhen Bay,Arrival,809,94,7,910
2/15/2020,Q1,5,B,Shenzhen Bay,Departure,945,621,150,1716
2/15/2020,Q1,5,B,China Ferry Terminal,Arrival,0,0,0,0
2/15/2020,Q1,5,B,China Ferry Terminal,Departure,0,0,0,0
2/15/2020,Q1,5,B,Harbour Control,Arrival,0,0,0,0
2/15/2020,Q1,5,B,Harbour Control,Departure,0,0,0,0
2/15/2020,Q1,5,B,Kai Tak Cruise Terminal,Arrival,0,0,0,0
2/15/2020,Q1,5,B,Kai Tak Cruise Terminal,Departure,0,0,0,0
2/15/2020,Q1,5,B,Macau Ferry Terminal,Arrival,0,0,0,0
2/15/2020,Q1,5,B,Macau Ferry Terminal,Departure,0,0,0,0
2/15/2020,Q1,5,B,Tuen Mun Ferry Terminal,Arrival,0,0,0,0
2/15/2020,Q1,5,B,Tuen Mun Ferry Terminal,Departure,0,0,0,0
2/16/2020,Q1,5,B,Airport,Arrival,18422,650,1848,20920
2/16/2020,Q1,5,B,Airport,Departure,12257,349,2524,15130
2/16/2020,Q1,5,B,Express Rail Link West Kowloon,Arrival,0,0,0,0
2/16/2020,Q1,5,B,Express Rail Link West Kowloon,Departure,0,0,0,0
2/16/2020,Q1,5,B,Hung Hom,Arrival,0,0,0,0
2/16/2020,Q1,5,B,Hung Hom,Departure,0,0,0,0
2/16/2020,Q1,5,B,Lo Wu,Arrival,0,0,0,0
2/16/2020,Q1,5,B,Lo Wu,Departure,0,0,0,0
2/16/2020,Q1,5,B,Lok Ma Chau Spur Line,Arrival,0,0,0,0
2/16/2020,Q1,5,B,Lok Ma Chau Spur Line,Departure,0,0,0,0
2/16/2020,Q1,5,B,Hong Kong-Zhuhai-Macao Bridge,Arrival,1106,2,465,1573
2/16/2020,Q1,5,B,Hong Kong-Zhuhai-Macao Bridge,Departure,1473,76,646,2195
2/16/2020,Q1,5,B,Lok Ma Chau,Arrival,0,0,0,0
2/16/2020,Q1,5,B,Lok Ma Chau,Departure,0,0,0,0
2/16/2020,Q1,5,B,Man Kam To,Arrival,0,0,0,0
2/16/2020,Q1,5,B,Man Kam To,Departure,0,0,0,0
2/16/2020,Q1,5,B,Sha Tau Kok,Arrival,0,0,0,0
2/16/2020,Q1,5,B,Sha Tau Kok,Departure,0,0,0,0
2/16/2020,Q1,5,B,Shenzhen Bay,Arrival,797,97,6,900
2/16/2020,Q1,5,B,Shenzhen Bay,Departure,1166,764,203,2133
2/16/2020,Q1,5,B,China Ferry Terminal,Arrival,0,0,0,0
2/16/2020,Q1,5,B,China Ferry Terminal,Departure,0,0,0,0
2/16/2020,Q1,5,B,Harbour Control,Arrival,0,0,0,0
2/16/2020,Q1,5,B,Harbour Control,Departure,0,0,0,0
2/16/2020,Q1,5,B,Kai Tak Cruise Terminal,Arrival,0,0,0,0
2/16/2020,Q1,5,B,Kai Tak Cruise Terminal,Departure,0,0,0,0
2/16/2020,Q1,5,B,Macau Ferry Terminal,Arrival,0,0,0,0
2/16/2020,Q1,5,B,Macau Ferry Terminal,Departure,0,0,0,0
2/16/2020,Q1,5,B,Tuen Mun Ferry Terminal,Arrival,0,0,0,0
2/16/2020,Q1,5,B,Tuen Mun Ferry Terminal,Departure,0,0,0,0
2/17/2020,Q1,5,B,Airport,Arrival,13748,532,1876,16156
2/17/2020,Q1,5,B,Airport,Departure,10210,212,2018,12440
2/17/2020,Q1,5,B,Express Rail Link West Kowloon,Arrival,0,0,0,0
2/17/2020,Q1,5,B,Express Rail Link West Kowloon,Departure,0,0,0,0
2/17/2020,Q1,5,B,Hung Hom,Arrival,0,0,0,0
2/17/2020,Q1,5,B,Hung Hom,Departure,0,0,0,0
2/17/2020,Q1,5,B,Lo Wu,Arrival,0,0,0,0
2/17/2020,Q1,5,B,Lo Wu,Departure,0,0,0,0
2/17/2020,Q1,5,B,Lok Ma Chau Spur Line,Arrival,0,0,0,0
2/17/2020,Q1,5,B,Lok Ma Chau Spur Line,Departure,0,0,0,0
2/17/2020,Q1,5,B,Hong Kong-Zhuhai-Macao Bridge,Arrival,1264,3,488,1755
2/17/2020,Q1,5,B,Hong Kong-Zhuhai-Macao Bridge,Departure,2000,87,625,2712
2/17/2020,Q1,5,B,Lok Ma Chau,Arrival,0,0,0,0
2/17/2020,Q1,5,B,Lok Ma Chau,Departure,0,0,0,0
2/17/2020,Q1,5,B,Man Kam To,Arrival,0,0,0,0
2/17/2020,Q1,5,B,Man Kam To,Departure,0,0,0,0
2/17/2020,Q1,5,B,Sha Tau Kok,Arrival,0,0,0,0
2/17/2020,Q1,5,B,Sha Tau Kok,Departure,0,0,0,0
2/17/2020,Q1,5,B,Shenzhen Bay,Arrival,978,108,4,1090
2/17/2020,Q1,5,B,Shenzhen Bay,Departure,1724,600,173,2497
2/17/2020,Q1,5,B,China Ferry Terminal,Arrival,0,0,0,0
2/17/2020,Q1,5,B,China Ferry Terminal,Departure,0,0,0,0
2/17/2020,Q1,5,B,Harbour Control,Arrival,0,0,0,0
2/17/2020,Q1,5,B,Harbour Control,Departure,0,0,0,0
2/17/2020,Q1,5,B,Kai Tak Cruise Terminal,Arrival,0,0,0,0
2/17/2020,Q1,5,B,Kai Tak Cruise Terminal,Departure,0,0,0,0
2/17/2020,Q1,5,B,Macau Ferry Terminal,Arrival,0,0,0,0
2/17/2020,Q1,5,B,Macau Ferry Terminal,Departure,0,0,0,0
2/17/2020,Q1,5,B,Tuen Mun Ferry Terminal,Arrival,0,0,0,0
2/17/2020,Q1,5,B,Tuen Mun Ferry Terminal,Departure,0,0,0,0
2/18/2020,Q1,5,B,Airport,Arrival,12068,479,1862,14409
2/18/2020,Q1,5,B,Airport,Departure,8900,266,1722,10888
2/18/2020,Q1,5,B,Express Rail Link West Kowloon,Arrival,0,0,0,0
2/18/2020,Q1,5,B,Express Rail Link West Kowloon,Departure,0,0,0,0
2/18/2020,Q1,5,B,Hung Hom,Arrival,0,0,0,0
2/18/2020,Q1,5,B,Hung Hom,Departure,0,0,0,0
2/18/2020,Q1,5,B,Lo Wu,Arrival,0,0,0,0
2/18/2020,Q1,5,B,Lo Wu,Departure,0,0,0,0
2/18/2020,Q1,5,B,Lok Ma Chau Spur Line,Arrival,0,0,0,0
2/18/2020,Q1,5,B,Lok Ma Chau Spur Line,Departure,0,0,0,0
2/18/2020,Q1,5,B,Hong Kong-Zhuhai-Macao Bridge,Arrival,1361,5,579,1945
2/18/2020,Q1,5,B,Hong Kong-Zhuhai-Macao Bridge,Departure,1955,74,730,2759
2/18/2020,Q1,5,B,Lok Ma Chau,Arrival,0,0,0,0
2/18/2020,Q1,5,B,Lok Ma Chau,Departure,0,0,0,0
2/18/2020,Q1,5,B,Man Kam To,Arrival,0,0,0,0
2/18/2020,Q1,5,B,Man Kam To,Departure,0,0,0,0
2/18/2020,Q1,5,B,Sha Tau Kok,Arrival,0,0,0,0
2/18/2020,Q1,5,B,Sha Tau Kok,Departure,0,0,0,0
2/18/2020,Q1,5,B,Shenzhen Bay,Arrival,954,95,10,1059
2/18/2020,Q1,5,B,Shenzhen Bay,Departure,1160,519,155,1834
2/18/2020,Q1,5,B,China Ferry Terminal,Arrival,0,0,0,0
2/18/2020,Q1,5,B,China Ferry Terminal,Departure,0,0,0,0
2/18/2020,Q1,5,B,Harbour Control,Arrival,0,0,0,0
2/18/2020,Q1,5,B,Harbour Control,Departure,0,0,0,0
2/18/2020,Q1,5,B,Kai Tak Cruise Terminal,Arrival,0,0,0,0
2/18/2020,Q1,5,B,Kai Tak Cruise Terminal,Departure,0,0,0,0
2/18/2020,Q1,5,B,Macau Ferry Terminal,Arrival,0,0,0,0
2/18/2020,Q1,5,B,Macau Ferry Terminal,Departure,0,0,0,0
2/18/2020,Q1,5,B,Tuen Mun Ferry Terminal,Arrival,0,0,0,0
2/18/2020,Q1,5,B,Tuen Mun Ferry Terminal,Departure,0,0,0,0
2/19/2020,Q1,5,B,Airport,Arrival,10612,462,1789,12863
2/19/2020,Q1,5,B,Airport,Departure,10048,214,1582,11844
2/19/2020,Q1,5,B,Express Rail Link West Kowloon,Arrival,0,0,0,0
2/19/2020,Q1,5,B,Express Rail Link West Kowloon,Departure,0,0,0,0
2/19/2020,Q1,5,B,Hung Hom,Arrival,0,0,0,0
2/19/2020,Q1,5,B,Hung Hom,Departure,0,0,0,0
2/19/2020,Q1,5,B,Lo Wu,Arrival,0,0,0,0
2/19/2020,Q1,5,B,Lo Wu,Departure,0,0,0,0
2/19/2020,Q1,5,B,Lok Ma Chau Spur Line,Arrival,0,0,0,0
2/19/2020,Q1,5,B,Lok Ma Chau Spur Line,Departure,0,0,0,0
2/19/2020,Q1,5,B,Hong Kong-Zhuhai-Macao Bridge,Arrival,1280,8,496,1784
2/19/2020,Q1,5,B,Hong Kong-Zhuhai-Macao Bridge,Departure,1776,64,609,2449
2/19/2020,Q1,5,B,Lok Ma Chau,Arrival,0,0,0,0
2/19/2020,Q1,5,B,Lok Ma Chau,Departure,0,0,0,0
2/19/2020,Q1,5,B,Man Kam To,Arrival,0,0,0,0
2/19/2020,Q1,5,B,Man Kam To,Departure,0,0,0,0
2/19/2020,Q1,5,B,Sha Tau Kok,Arrival,0,0,0,0
2/19/2020,Q1,5,B,Sha Tau Kok,Departure,0,0,0,0
2/19/2020,Q1,5,B,Shenzhen Bay,Arrival,909,97,5,1011
2/19/2020,Q1,5,B,Shenzhen Bay,Departure,1145,508,113,1766
2/19/2020,Q1,5,B,China Ferry Terminal,Arrival,0,0,0,0
2/19/2020,Q1,5,B,China Ferry Terminal,Departure,0,0,0,0
2/19/2020,Q1,5,B,Harbour Control,Arrival,0,0,0,0
2/19/2020,Q1,5,B,Harbour Control,Departure,0,0,0,0
2/19/2020,Q1,5,B,Kai Tak Cruise Terminal,Arrival,0,0,0,0
2/19/2020,Q1,5,B,Kai Tak Cruise Terminal,Departure,0,0,0,0
2/19/2020,Q1,5,B,Macau Ferry Terminal,Arrival,0,0,0,0
2/19/2020,Q1,5,B,Macau Ferry Terminal,Departure,0,0,0,0
2/19/2020,Q1,5,B,Tuen Mun Ferry Terminal,Arrival,0,0,0,0
2/19/2020,Q1,5,B,Tuen Mun Ferry Terminal,Departure,0,0,0,0
2/20/2020,Q1,5,B,Airport,Arrival,10398,525,1730,12653
2/20/2020,Q1,5,B,Airport,Departure,11622,280,1944,13846
2/20/2020,Q1,5,B,Express Rail Link West Kowloon,Arrival,0,0,0,0
2/20/2020,Q1,5,B,Express Rail Link West Kowloon,Departure,0,0,0,0
2/20/2020,Q1,5,B,Hung Hom,Arrival,0,0,0,0
2/20/2020,Q1,5,B,Hung Hom,Departure,0,0,0,0
2/20/2020,Q1,5,B,Lo Wu,Arrival,0,0,0,0
2/20/2020,Q1,5,B,Lo Wu,Departure,0,0,0,0
2/20/2020,Q1,5,B,Lok Ma Chau Spur Line,Arrival,0,0,0,0
2/20/2020,Q1,5,B,Lok Ma Chau Spur Line,Departure,0,0,0,0
2/20/2020,Q1,5,B,Hong Kong-Zhuhai-Macao Bridge,Arrival,2299,13,585,2897
2/20/2020,Q1,5,B,Hong Kong-Zhuhai-Macao Bridge,Departure,3135,96,551,3782
2/20/2020,Q1,5,B,Lok Ma Chau,Arrival,0,0,0,0
2/20/2020,Q1,5,B,Lok Ma Chau,Departure,0,0,0,0
2/20/2020,Q1,5,B,Man Kam To,Arrival,0,0,0,0
2/20/2020,Q1,5,B,Man Kam To,Departure,0,0,0,0
2/20/2020,Q1,5,B,Sha Tau Kok,Arrival,0,0,0,0
2/20/2020,Q1,5,B,Sha Tau Kok,Departure,0,0,0,0
2/20/2020,Q1,5,B,Shenzhen Bay,Arrival,980,110,9,1099
2/20/2020,Q1,5,B,Shenzhen Bay,Departure,1167,564,111,1842
2/20/2020,Q1,5,B,China Ferry Terminal,Arrival,0,0,0,0
2/20/2020,Q1,5,B,China Ferry Terminal,Departure,0,0,0,0
2/20/2020,Q1,5,B,Harbour Control,Arrival,0,0,0,0
2/20/2020,Q1,5,B,Harbour Control,Departure,0,0,0,0
2/20/2020,Q1,5,B,Kai Tak Cruise Terminal,Arrival,0,0,0,0
2/20/2020,Q1,5,B,Kai Tak Cruise Terminal,Departure,0,0,0,0
2/20/2020,Q1,5,B,Macau Ferry Terminal,Arrival,0,0,0,0
2/20/2020,Q1,5,B,Macau Ferry Terminal,Departure,0,0,0,0
2/20/2020,Q1,5,B,Tuen Mun Ferry Terminal,Arrival,0,0,0,0
2/20/2020,Q1,5,B,Tuen Mun Ferry Terminal,Departure,0,0,0,0
2/21/2020,Q1,5,B,Airport,Arrival,9821,539,2007,12367
2/21/2020,Q1,5,B,Airport,Departure,12942,356,1749,15047
2/21/2020,Q1,5,B,Express Rail Link West Kowloon,Arrival,0,0,0,0
2/21/2020,Q1,5,B,Express Rail Link West Kowloon,Departure,0,0,0,0
2/21/2020,Q1,5,B,Hung Hom,Arrival,0,0,0,0
2/21/2020,Q1,5,B,Hung Hom,Departure,0,0,0,0
2/21/2020,Q1,5,B,Lo Wu,Arrival,0,0,0,0
2/21/2020,Q1,5,B,Lo Wu,Departure,0,0,0,0
2/21/2020,Q1,5,B,Lok Ma Chau Spur Line,Arrival,0,0,0,0
2/21/2020,Q1,5,B,Lok Ma Chau Spur Line,Departure,0,0,0,0
2/21/2020,Q1,5,B,Hong Kong-Zhuhai-Macao Bridge,Arrival,3647,28,685,4360
2/21/2020,Q1,5,B,Hong Kong-Zhuhai-Macao Bridge,Departure,3362,95,549,4006
2/21/2020,Q1,5,B,Lok Ma Chau,Arrival,0,0,0,0
2/21/2020,Q1,5,B,Lok Ma Chau,Departure,0,0,0,0
2/21/2020,Q1,5,B,Man Kam To,Arrival,0,0,0,0
2/21/2020,Q1,5,B,Man Kam To,Departure,0,0,0,0
2/21/2020,Q1,5,B,Sha Tau Kok,Arrival,0,0,0,0
2/21/2020,Q1,5,B,Sha Tau Kok,Departure,0,0,0,0
2/21/2020,Q1,5,B,Shenzhen Bay,Arrival,1089,115,4,1208
2/21/2020,Q1,5,B,Shenzhen Bay,Departure,1195,534,115,1844
2/21/2020,Q1,5,B,China Ferry Terminal,Arrival,0,0,0,0
2/21/2020,Q1,5,B,China Ferry Terminal,Departure,0,0,0,0
2/21/2020,Q1,5,B,Harbour Control,Arrival,0,0,0,0
2/21/2020,Q1,5,B,Harbour Control,Departure,0,0,0,0
2/21/2020,Q1,5,B,Kai Tak Cruise Terminal,Arrival,0,0,0,0
2/21/2020,Q1,5,B,Kai Tak Cruise Terminal,Departure,0,0,0,0
2/21/2020,Q1,5,B,Macau Ferry Terminal,Arrival,0,0,0,0
2/21/2020,Q1,5,B,Macau Ferry Terminal,Departure,0,0,0,0
2/21/2020,Q1,5,B,Tuen Mun Ferry Terminal,Arrival,0,0,0,0
2/21/2020,Q1,5,B,Tuen Mun Ferry Terminal,Departure,0,0,0,0
2/22/2020,Q1,5,B,Airport,Arrival,11096,530,2030,13656
2/22/2020,Q1,5,B,Airport,Departure,10534,247,1888,12669
2/22/2020,Q1,5,B,Express Rail Link West Kowloon,Arrival,0,0,0,0
2/22/2020,Q1,5,B,Express Rail Link West Kowloon,Departure,0,0,0,0
2/22/2020,Q1,5,B,Hung Hom,Arrival,0,0,0,0
2/22/2020,Q1,5,B,Hung Hom,Departure,0,0,0,0
2/22/2020,Q1,5,B,Lo Wu,Arrival,0,0,0,0
2/22/2020,Q1,5,B,Lo Wu,Departure,0,0,0,0
2/22/2020,Q1,5,B,Lok Ma Chau Spur Line,Arrival,0,0,0,0
2/22/2020,Q1,5,B,Lok Ma Chau Spur Line,Departure,0,0,0,0
2/22/2020,Q1,5,B,Hong Kong-Zhuhai-Macao Bridge,Arrival,3364,14,648,4026
2/22/2020,Q1,5,B,Hong Kong-Zhuhai-Macao Bridge,Departure,3511,83,641,4235
2/22/2020,Q1,5,B,Lok Ma Chau,Arrival,0,0,0,0
2/22/2020,Q1,5,B,Lok Ma Chau,Departure,0,0,0,0
2/22/2020,Q1,5,B,Man Kam To,Arrival,0,0,0,0
2/22/2020,Q1,5,B,Man Kam To,Departure,0,0,0,0
2/22/2020,Q1,5,B,Sha Tau Kok,Arrival,0,0,0,0
2/22/2020,Q1,5,B,Sha Tau Kok,Departure,0,0,0,0
2/22/2020,Q1,5,B,Shenzhen Bay,Arrival,980,107,2,1089
2/22/2020,Q1,5,B,Shenzhen Bay,Departure,1115,487,124,1726
2/22/2020,Q1,5,B,China Ferry Terminal,Arrival,0,0,0,0
2/22/2020,Q1,5,B,China Ferry Terminal,Departure,0,0,0,0
2/22/2020,Q1,5,B,Harbour Control,Arrival,0,0,0,0
2/22/2020,Q1,5,B,Harbour Control,Departure,0,0,0,0
2/22/2020,Q1,5,B,Kai Tak Cruise Terminal,Arrival,0,0,0,0
2/22/2020,Q1,5,B,Kai Tak Cruise Terminal,Departure,0,0,0,0
2/22/2020,Q1,5,B,Macau Ferry Terminal,Arrival,0,0,0,0
2/22/2020,Q1,5,B,Macau Ferry Terminal,Departure,0,0,0,0
2/22/2020,Q1,5,B,Tuen Mun Ferry Terminal,Arrival,0,0,0,0
2/22/2020,Q1,5,B,Tuen Mun Ferry Terminal,Departure,0,0,0,0
2/23/2020,Q1,5,B,Airport,Arrival,15891,537,2009,18437
2/23/2020,Q1,5,B,Airport,Departure,9225,296,2141,11662
2/23/2020,Q1,5,B,Express Rail Link West Kowloon,Arrival,0,0,0,0
2/23/2020,Q1,5,B,Express Rail Link West Kowloon,Departure,0,0,0,0
2/23/2020,Q1,5,B,Hung Hom,Arrival,0,0,0,0
2/23/2020,Q1,5,B,Hung Hom,Departure,0,0,0,0
2/23/2020,Q1,5,B,Lo Wu,Arrival,0,0,0,0
2/23/2020,Q1,5,B,Lo Wu,Departure,0,0,0,0
2/23/2020,Q1,5,B,Lok Ma Chau Spur Line,Arrival,0,0,0,0
2/23/2020,Q1,5,B,Lok Ma Chau Spur Line,Departure,0,0,0,0
2/23/2020,Q1,5,B,Hong Kong-Zhuhai-Macao Bridge,Arrival,3203,10,633,3846
2/23/2020,Q1,5,B,Hong Kong-Zhuhai-Macao Bridge,Departure,3342,86,775,4203
2/23/2020,Q1,5,B,Lok Ma Chau,Arrival,0,0,0,0
2/23/2020,Q1,5,B,Lok Ma Chau,Departure,0,0,0,0
2/23/2020,Q1,5,B,Man Kam To,Arrival,0,0,0,0
2/23/2020,Q1,5,B,Man Kam To,Departure,0,0,0,0
2/23/2020,Q1,5,B,Sha Tau Kok,Arrival,0,0,0,0
2/23/2020,Q1,5,B,Sha Tau Kok,Departure,0,0,0,0
2/23/2020,Q1,5,B,Shenzhen Bay,Arrival,1147,126,9,1282
2/23/2020,Q1,5,B,Shenzhen Bay,Departure,1338,579,273,2190
2/23/2020,Q1,5,B,China Ferry Terminal,Arrival,0,0,0,0
2/23/2020,Q1,5,B,China Ferry Terminal,Departure,0,0,0,0
2/23/2020,Q1,5,B,Harbour Control,Arrival,0,0,0,0
2/23/2020,Q1,5,B,Harbour Control,Departure,0,0,0,0
2/23/2020,Q1,5,B,Kai Tak Cruise Terminal,Arrival,0,0,0,0
2/23/2020,Q1,5,B,Kai Tak Cruise Terminal,Departure,0,0,0,0
2/23/2020,Q1,5,B,Macau Ferry Terminal,Arrival,0,0,0,0
2/23/2020,Q1,5,B,Macau Ferry Terminal,Departure,0,0,0,0
2/23/2020,Q1,5,B,Tuen Mun Ferry Terminal,Arrival,0,0,0,0
2/23/2020,Q1,5,B,Tuen Mun Ferry Terminal,Departure,0,0,0,0
2/24/2020,Q1,5,B,Airport,Arrival,12267,451,1792,14510
2/24/2020,Q1,5,B,Airport,Departure,8041,231,1919,10191
2/24/2020,Q1,5,B,Express Rail Link West Kowloon,Arrival,0,0,0,0
2/24/2020,Q1,5,B,Express Rail Link West Kowloon,Departure,0,0,0,0
2/24/2020,Q1,5,B,Hung Hom,Arrival,0,0,0,0
2/24/2020,Q1,5,B,Hung Hom,Departure,0,0,0,0
2/24/2020,Q1,5,B,Lo Wu,Arrival,0,0,0,0
2/24/2020,Q1,5,B,Lo Wu,Departure,0,0,0,0
2/24/2020,Q1,5,B,Lok Ma Chau Spur Line,Arrival,0,0,0,0
2/24/2020,Q1,5,B,Lok Ma Chau Spur Line,Departure,0,0,0,0
2/24/2020,Q1,5,B,Hong Kong-Zhuhai-Macao Bridge,Arrival,3352,7,611,3970
2/24/2020,Q1,5,B,Hong Kong-Zhuhai-Macao Bridge,Departure,4211,74,682,4967
2/24/2020,Q1,5,B,Lok Ma Chau,Arrival,0,0,0,0
2/24/2020,Q1,5,B,Lok Ma Chau,Departure,0,0,0,0
2/24/2020,Q1,5,B,Man Kam To,Arrival,0,0,0,0
2/24/2020,Q1,5,B,Man Kam To,Departure,0,0,0,0
2/24/2020,Q1,5,B,Sha Tau Kok,Arrival,0,0,0,0
2/24/2020,Q1,5,B,Sha Tau Kok,Departure,0,0,0,0
2/24/2020,Q1,5,B,Shenzhen Bay,Arrival,1353,130,7,1490
2/24/2020,Q1,5,B,Shenzhen Bay,Departure,1964,482,181,2627
2/24/2020,Q1,5,B,China Ferry Terminal,Arrival,0,0,0,0
2/24/2020,Q1,5,B,China Ferry Terminal,Departure,0,0,0,0
2/24/2020,Q1,5,B,Harbour Control,Arrival,0,0,0,0
2/24/2020,Q1,5,B,Harbour Control,Departure,0,0,0,0
2/24/2020,Q1,5,B,Kai Tak Cruise Terminal,Arrival,0,0,0,0
2/24/2020,Q1,5,B,Kai Tak Cruise Terminal,Departure,0,0,0,0
2/24/2020,Q1,5,B,Macau Ferry Terminal,Arrival,0,0,0,0
2/24/2020,Q1,5,B,Macau Ferry Terminal,Departure,0,0,0,0
2/24/2020,Q1,5,B,Tuen Mun Ferry Terminal,Arrival,0,0,0,0
2/24/2020,Q1,5,B,Tuen Mun Ferry Terminal,Departure,0,0,0,0
2/25/2020,Q1,5,B,Airport,Arrival,10734,414,1471,12619
2/25/2020,Q1,5,B,Airport,Departure,7458,181,1574,9213
2/25/2020,Q1,5,B,Express Rail Link West Kowloon,Arrival,0,0,0,0
2/25/2020,Q1,5,B,Express Rail Link West Kowloon,Departure,0,0,0,0
2/25/2020,Q1,5,B,Hung Hom,Arrival,0,0,0,0
2/25/2020,Q1,5,B,Hung Hom,Departure,0,0,0,0
2/25/2020,Q1,5,B,Lo Wu,Arrival,0,0,0,0
2/25/2020,Q1,5,B,Lo Wu,Departure,0,0,0,0
2/25/2020,Q1,5,B,Lok Ma Chau Spur Line,Arrival,0,0,0,0
2/25/2020,Q1,5,B,Lok Ma Chau Spur Line,Departure,0,0,0,0
2/25/2020,Q1,5,B,Hong Kong-Zhuhai-Macao Bridge,Arrival,3145,13,591,3749
2/25/2020,Q1,5,B,Hong Kong-Zhuhai-Macao Bridge,Departure,3281,88,593,3962
2/25/2020,Q1,5,B,Lok Ma Chau,Arrival,0,0,0,0
2/25/2020,Q1,5,B,Lok Ma Chau,Departure,0,0,0,0
2/25/2020,Q1,5,B,Man Kam To,Arrival,0,0,0,0
2/25/2020,Q1,5,B,Man Kam To,Departure,0,0,0,0
2/25/2020,Q1,5,B,Sha Tau Kok,Arrival,0,0,0,0
2/25/2020,Q1,5,B,Sha Tau Kok,Departure,0,0,0,0
2/25/2020,Q1,5,B,Shenzhen Bay,Arrival,1328,131,5,1464
2/25/2020,Q1,5,B,Shenzhen Bay,Departure,1510,503,141,2154
2/25/2020,Q1,5,B,China Ferry Terminal,Arrival,0,0,0,0
2/25/2020,Q1,5,B,China Ferry Terminal,Departure,0,0,0,0
2/25/2020,Q1,5,B,Harbour Control,Arrival,0,0,0,0
2/25/2020,Q1,5,B,Harbour Control,Departure,0,0,0,0
2/25/2020,Q1,5,B,Kai Tak Cruise Terminal,Arrival,0,0,0,0
2/25/2020,Q1,5,B,Kai Tak Cruise Terminal,Departure,0,0,0,0
2/25/2020,Q1,5,B,Macau Ferry Terminal,Arrival,0,0,0,0
2/25/2020,Q1,5,B,Macau Ferry Terminal,Departure,0,0,0,0
2/25/2020,Q1,5,B,Tuen Mun Ferry Terminal,Arrival,0,0,0,0
2/25/2020,Q1,5,B,Tuen Mun Ferry Terminal,Departure,0,0,0,0
2/26/2020,Q1,5,B,Airport,Arrival,9882,410,1484,11776
2/26/2020,Q1,5,B,Airport,Departure,7629,212,1521,9362
2/26/2020,Q1,5,B,Express Rail Link West Kowloon,Arrival,0,0,0,0
2/26/2020,Q1,5,B,Express Rail Link West Kowloon,Departure,0,0,0,0
2/26/2020,Q1,5,B,Hung Hom,Arrival,0,0,0,0
2/26/2020,Q1,5,B,Hung Hom,Departure,0,0,0,0
2/26/2020,Q1,5,B,Lo Wu,Arrival,0,0,0,0
2/26/2020,Q1,5,B,Lo Wu,Departure,0,0,0,0
2/26/2020,Q1,5,B,Lok Ma Chau Spur Line,Arrival,0,0,0,0
2/26/2020,Q1,5,B,Lok Ma Chau Spur Line,Departure,0,0,0,0
2/26/2020,Q1,5,B,Hong Kong-Zhuhai-Macao Bridge,Arrival,3233,11,662,3906
2/26/2020,Q1,5,B,Hong Kong-Zhuhai-Macao Bridge,Departure,3424,78,580,4082
2/26/2020,Q1,5,B,Lok Ma Chau,Arrival,0,0,0,0
2/26/2020,Q1,5,B,Lok Ma Chau,Departure,0,0,0,0
2/26/2020,Q1,5,B,Man Kam To,Arrival,0,0,0,0
2/26/2020,Q1,5,B,Man Kam To,Departure,0,0,0,0
2/26/2020,Q1,5,B,Sha Tau Kok,Arrival,0,0,0,0
2/26/2020,Q1,5,B,Sha Tau Kok,Departure,0,0,0,0
2/26/2020,Q1,5,B,Shenzhen Bay,Arrival,1202,166,11,1379
2/26/2020,Q1,5,B,Shenzhen Bay,Departure,1695,548,179,2422
2/26/2020,Q1,5,B,China Ferry Terminal,Arrival,0,0,0,0
2/26/2020,Q1,5,B,China Ferry Terminal,Departure,0,0,0,0
2/26/2020,Q1,5,B,Harbour Control,Arrival,0,0,0,0
2/26/2020,Q1,5,B,Harbour Control,Departure,0,0,0,0
2/26/2020,Q1,5,B,Kai Tak Cruise Terminal,Arrival,0,0,0,0
2/26/2020,Q1,5,B,Kai Tak Cruise Terminal,Departure,0,0,0,0
2/26/2020,Q1,5,B,Macau Ferry Terminal,Arrival,0,0,0,0
2/26/2020,Q1,5,B,Macau Ferry Terminal,Departure,0,0,0,0
2/26/2020,Q1,5,B,Tuen Mun Ferry Terminal,Arrival,0,0,0,0
2/26/2020,Q1,5,B,Tuen Mun Ferry Terminal,Departure,0,0,0,0
2/27/2020,Q1,5,B,Airport,Arrival,9177,512,1780,11469
2/27/2020,Q1,5,B,Airport,Departure,9051,168,1501,10720
2/27/2020,Q1,5,B,Express Rail Link West Kowloon,Arrival,0,0,0,0
2/27/2020,Q1,5,B,Express Rail Link West Kowloon,Departure,0,0,0,0
2/27/2020,Q1,5,B,Hung Hom,Arrival,0,0,0,0
2/27/2020,Q1,5,B,Hung Hom,Departure,0,0,0,0
2/27/2020,Q1,5,B,Lo Wu,Arrival,0,0,0,0
2/27/2020,Q1,5,B,Lo Wu,Departure,0,0,0,0
2/27/2020,Q1,5,B,Lok Ma Chau Spur Line,Arrival,0,0,0,0
2/27/2020,Q1,5,B,Lok Ma Chau Spur Line,Departure,0,0,0,0
2/27/2020,Q1,5,B,Hong Kong-Zhuhai-Macao Bridge,Arrival,3420,20,616,4056
2/27/2020,Q1,5,B,Hong Kong-Zhuhai-Macao Bridge,Departure,3672,99,670,4441
2/27/2020,Q1,5,B,Lok Ma Chau,Arrival,0,0,0,0
2/27/2020,Q1,5,B,Lok Ma Chau,Departure,0,0,0,0
2/27/2020,Q1,5,B,Man Kam To,Arrival,0,0,0,0
2/27/2020,Q1,5,B,Man Kam To,Departure,0,0,0,0
2/27/2020,Q1,5,B,Sha Tau Kok,Arrival,0,0,0,0
2/27/2020,Q1,5,B,Sha Tau Kok,Departure,0,0,0,0
2/27/2020,Q1,5,B,Shenzhen Bay,Arrival,1249,170,8,1427
2/27/2020,Q1,5,B,Shenzhen Bay,Departure,1564,647,183,2394
2/27/2020,Q1,5,B,China Ferry Terminal,Arrival,0,0,0,0
2/27/2020,Q1,5,B,China Ferry Terminal,Departure,0,0,0,0
2/27/2020,Q1,5,B,Harbour Control,Arrival,0,0,0,0
2/27/2020,Q1,5,B,Harbour Control,Departure,0,0,0,0
2/27/2020,Q1,5,B,Kai Tak Cruise Terminal,Arrival,0,0,0,0
2/27/2020,Q1,5,B,Kai Tak Cruise Terminal,Departure,0,0,0,0
2/27/2020,Q1,5,B,Macau Ferry Terminal,Arrival,0,0,0,0
2/27/2020,Q1,5,B,Macau Ferry Terminal,Departure,0,0,0,0
2/27/2020,Q1,5,B,Tuen Mun Ferry Terminal,Arrival,0,0,0,0
2/27/2020,Q1,5,B,Tuen Mun Ferry Terminal,Departure,0,0,0,0
2/28/2020,Q1,5,B,Airport,Arrival,9205,369,1767,11341
2/28/2020,Q1,5,B,Airport,Departure,10755,255,1747,12757
2/28/2020,Q1,5,B,Express Rail Link West Kowloon,Arrival,0,0,0,0
2/28/2020,Q1,5,B,Express Rail Link West Kowloon,Departure,0,0,0,0
2/28/2020,Q1,5,B,Hung Hom,Arrival,0,0,0,0
2/28/2020,Q1,5,B,Hung Hom,Departure,0,0,0,0
2/28/2020,Q1,5,B,Lo Wu,Arrival,0,0,0,0
2/28/2020,Q1,5,B,Lo Wu,Departure,0,0,0,0
2/28/2020,Q1,5,B,Lok Ma Chau Spur Line,Arrival,0,0,0,0
2/28/2020,Q1,5,B,Lok Ma Chau Spur Line,Departure,0,0,0,0
2/28/2020,Q1,5,B,Hong Kong-Zhuhai-Macao Bridge,Arrival,4763,8,865,5636
2/28/2020,Q1,5,B,Hong Kong-Zhuhai-Macao Bridge,Departure,4669,90,663,5422
2/28/2020,Q1,5,B,Lok Ma Chau,Arrival,0,0,0,0
2/28/2020,Q1,5,B,Lok Ma Chau,Departure,0,0,0,0
2/28/2020,Q1,5,B,Man Kam To,Arrival,0,0,0,0
2/28/2020,Q1,5,B,Man Kam To,Departure,0,0,0,0
2/28/2020,Q1,5,B,Sha Tau Kok,Arrival,0,0,0,0
2/28/2020,Q1,5,B,Sha Tau Kok,Departure,0,0,0,0
2/28/2020,Q1,5,B,Shenzhen Bay,Arrival,1280,181,10,1471
2/28/2020,Q1,5,B,Shenzhen Bay,Departure,1724,566,175,2465
2/28/2020,Q1,5,B,China Ferry Terminal,Arrival,0,0,0,0
2/28/2020,Q1,5,B,China Ferry Terminal,Departure,0,0,0,0
2/28/2020,Q1,5,B,Harbour Control,Arrival,0,0,0,0
2/28/2020,Q1,5,B,Harbour Control,Departure,0,0,0,0
2/28/2020,Q1,5,B,Kai Tak Cruise Terminal,Arrival,0,0,0,0
2/28/2020,Q1,5,B,Kai Tak Cruise Terminal,Departure,0,0,0,0
2/28/2020,Q1,5,B,Macau Ferry Terminal,Arrival,0,0,0,0
2/28/2020,Q1,5,B,Macau Ferry Terminal,Departure,0,0,0,0
2/28/2020,Q1,5,B,Tuen Mun Ferry Terminal,Arrival,0,0,0,0
2/28/2020,Q1,5,B,Tuen Mun Ferry Terminal,Departure,0,0,0,0
2/29/2020,Q1,5,B,Airport,Arrival,11818,870,1893,14581
2/29/2020,Q1,5,B,Airport,Departure,9860,230,1688,11778
2/29/2020,Q1,5,B,Express Rail Link West Kowloon,Arrival,0,0,0,0
2/29/2020,Q1,5,B,Express Rail Link West Kowloon,Departure,0,0,0,0
2/29/2020,Q1,5,B,Hung Hom,Arrival,0,0,0,0
2/29/2020,Q1,5,B,Hung Hom,Departure,0,0,0,0
2/29/2020,Q1,5,B,Lo Wu,Arrival,0,0,0,0
2/29/2020,Q1,5,B,Lo Wu,Departure,0,0,0,0
2/29/2020,Q1,5,B,Lok Ma Chau Spur Line,Arrival,0,0,0,0
2/29/2020,Q1,5,B,Lok Ma Chau Spur Line,Departure,0,0,0,0
2/29/2020,Q1,5,B,Hong Kong-Zhuhai-Macao Bridge,Arrival,4676,19,901,5596
2/29/2020,Q1,5,B,Hong Kong-Zhuhai-Macao Bridge,Departure,4866,87,787,5740
2/29/2020,Q1,5,B,Lok Ma Chau,Arrival,0,0,0,0
2/29/2020,Q1,5,B,Lok Ma Chau,Departure,0,0,0,0
2/29/2020,Q1,5,B,Man Kam To,Arrival,0,0,0,0
2/29/2020,Q1,5,B,Man Kam To,Departure,0,0,0,0
2/29/2020,Q1,5,B,Sha Tau Kok,Arrival,0,0,0,0
2/29/2020,Q1,5,B,Sha Tau Kok,Departure,0,0,0,0
2/29/2020,Q1,5,B,Shenzhen Bay,Arrival,1387,195,3,1585
2/29/2020,Q1,5,B,Shenzhen Bay,Departure,1807,947,329,3083
2/29/2020,Q1,5,B,China Ferry Terminal,Arrival,0,0,0,0
2/29/2020,Q1,5,B,China Ferry Terminal,Departure,0,0,0,0
2/29/2020,Q1,5,B,Harbour Control,Arrival,0,0,0,0
2/29/2020,Q1,5,B,Harbour Control,Departure,0,0,0,0
2/29/2020,Q1,5,B,Kai Tak Cruise Terminal,Arrival,0,0,0,0
2/29/2020,Q1,5,B,Kai Tak Cruise Terminal,Departure,0,0,0,0
2/29/2020,Q1,5,B,Macau Ferry Terminal,Arrival,0,0,0,0
2/29/2020,Q1,5,B,Macau Ferry Terminal,Departure,0,0,0,0
2/29/2020,Q1,5,B,Tuen Mun Ferry Terminal,Arrival,0,0,0,0
2/29/2020,Q1,5,B,Tuen Mun Ferry Terminal,Departure,0,0,0,0
3/1/2020,Q1,5,B,Airport,Arrival,14584,1122,2461,18167
3/1/2020,Q1,5,B,Airport,Departure,9115,354,1850,11319
3/1/2020,Q1,5,B,Express Rail Link West Kowloon,Arrival,0,0,0,0
3/1/2020,Q1,5,B,Express Rail Link West Kowloon,Departure,0,0,0,0
3/1/2020,Q1,5,B,Hung Hom,Arrival,0,0,0,0
3/1/2020,Q1,5,B,Hung Hom,Departure,0,0,0,0
3/1/2020,Q1,5,B,Lo Wu,Arrival,0,0,0,0
3/1/2020,Q1,5,B,Lo Wu,Departure,0,0,0,0
3/1/2020,Q1,5,B,Lok Ma Chau Spur Line,Arrival,0,0,0,0
3/1/2020,Q1,5,B,Lok Ma Chau Spur Line,Departure,0,0,0,0
3/1/2020,Q1,5,B,Hong Kong-Zhuhai-Macao Bridge,Arrival,4820,13,767,5600
3/1/2020,Q1,5,B,Hong Kong-Zhuhai-Macao Bridge,Departure,4587,194,905,5686
3/1/2020,Q1,5,B,Lok Ma Chau,Arrival,0,0,0,0
3/1/2020,Q1,5,B,Lok Ma Chau,Departure,0,0,0,0
3/1/2020,Q1,5,B,Man Kam To,Arrival,0,0,0,0
3/1/2020,Q1,5,B,Man Kam To,Departure,0,0,0,0
3/1/2020,Q1,5,B,Sha Tau Kok,Arrival,0,0,0,0
3/1/2020,Q1,5,B,Sha Tau Kok,Departure,0,0,0,0
3/1/2020,Q1,5,B,Shenzhen Bay,Arrival,1587,211,9,1807
3/1/2020,Q1,5,B,Shenzhen Bay,Departure,2053,1247,931,4231
3/1/2020,Q1,5,B,China Ferry Terminal,Arrival,0,0,0,0
3/1/2020,Q1,5,B,China Ferry Terminal,Departure,0,0,0,0
3/1/2020,Q1,5,B,Harbour Control,Arrival,0,0,0,0
3/1/2020,Q1,5,B,Harbour Control,Departure,0,0,0,0
3/1/2020,Q1,5,B,Kai Tak Cruise Terminal,Arrival,0,0,0,0
3/1/2020,Q1,5,B,Kai Tak Cruise Terminal,Departure,0,0,0,0
3/1/2020,Q1,5,B,Macau Ferry Terminal,Arrival,0,0,0,0
3/1/2020,Q1,5,B,Macau Ferry Terminal,Departure,0,0,0,0
3/1/2020,Q1,5,B,Tuen Mun Ferry Terminal,Arrival,0,0,0,0
3/1/2020,Q1,5,B,Tuen Mun Ferry Terminal,Departure,0,0,0,0
3/2/2020,Q1,5,B,Airport,Arrival,10261,732,1935,12928
3/2/2020,Q1,5,B,Airport,Departure,6755,206,1314,8275
3/2/2020,Q1,5,B,Express Rail Link West Kowloon,Arrival,0,0,0,0
3/2/2020,Q1,5,B,Express Rail Link West Kowloon,Departure,0,0,0,0
3/2/2020,Q1,5,B,Hung Hom,Arrival,0,0,0,0
3/2/2020,Q1,5,B,Hung Hom,Departure,0,0,0,0
3/2/2020,Q1,5,B,Lo Wu,Arrival,0,0,0,0
3/2/2020,Q1,5,B,Lo Wu,Departure,0,0,0,0
3/2/2020,Q1,5,B,Lok Ma Chau Spur Line,Arrival,0,0,0,0
3/2/2020,Q1,5,B,Lok Ma Chau Spur Line,Departure,0,0,0,0
3/2/2020,Q1,5,B,Hong Kong-Zhuhai-Macao Bridge,Arrival,4244,10,738,4992
3/2/2020,Q1,5,B,Hong Kong-Zhuhai-Macao Bridge,Departure,5321,93,836,6250
3/2/2020,Q1,5,B,Lok Ma Chau,Arrival,0,0,0,0
3/2/2020,Q1,5,B,Lok Ma Chau,Departure,0,0,0,0
3/2/2020,Q1,5,B,Man Kam To,Arrival,0,0,0,0
3/2/2020,Q1,5,B,Man Kam To,Departure,0,0,0,0
3/2/2020,Q1,5,B,Sha Tau Kok,Arrival,0,0,0,0
3/2/2020,Q1,5,B,Sha Tau Kok,Departure,0,0,0,0
3/2/2020,Q1,5,B,Shenzhen Bay,Arrival,2124,231,9,2364
3/2/2020,Q1,5,B,Shenzhen Bay,Departure,2551,924,655,4130
3/2/2020,Q1,5,B,China Ferry Terminal,Arrival,0,0,0,0
3/2/2020,Q1,5,B,China Ferry Terminal,Departure,0,0,0,0
3/2/2020,Q1,5,B,Harbour Control,Arrival,0,0,0,0
3/2/2020,Q1,5,B,Harbour Control,Departure,0,0,0,0
3/2/2020,Q1,5,B,Kai Tak Cruise Terminal,Arrival,0,0,0,0
3/2/2020,Q1,5,B,Kai Tak Cruise Terminal,Departure,0,0,0,0
3/2/2020,Q1,5,B,Macau Ferry Terminal,Arrival,0,0,0,0
3/2/2020,Q1,5,B,Macau Ferry Terminal,Departure,0,0,0,0
3/2/2020,Q1,5,B,Tuen Mun Ferry Terminal,Arrival,0,0,0,0
3/2/2020,Q1,5,B,Tuen Mun Ferry Terminal,Departure,0,0,0,0
3/3/2020,Q1,5,B,Airport,Arrival,7960,734,1923,10617
3/3/2020,Q1,5,B,Airport,Departure,6684,190,1349,8223
3/3/2020,Q1,5,B,Express Rail Link West Kowloon,Arrival,0,0,0,0
3/3/2020,Q1,5,B,Express Rail Link West Kowloon,Departure,0,0,0,0
3/3/2020,Q1,5,B,Hung Hom,Arrival,0,0,0,0
3/3/2020,Q1,5,B,Hung Hom,Departure,0,0,0,0
3/3/2020,Q1,5,B,Lo Wu,Arrival,0,0,0,0
3/3/2020,Q1,5,B,Lo Wu,Departure,0,0,0,0
3/3/2020,Q1,5,B,Lok Ma Chau Spur Line,Arrival,0,0,0,0
3/3/2020,Q1,5,B,Lok Ma Chau Spur Line,Departure,0,0,0,0
3/3/2020,Q1,5,B,Hong Kong-Zhuhai-Macao Bridge,Arrival,4398,19,756,5173
3/3/2020,Q1,5,B,Hong Kong-Zhuhai-Macao Bridge,Departure,4798,117,780,5695
3/3/2020,Q1,5,B,Lok Ma Chau,Arrival,0,0,0,0
3/3/2020,Q1,5,B,Lok Ma Chau,Departure,0,0,0,0
3/3/2020,Q1,5,B,Man Kam To,Arrival,0,0,0,0
3/3/2020,Q1,5,B,Man Kam To,Departure,0,0,0,0
3/3/2020,Q1,5,B,Sha Tau Kok,Arrival,0,0,0,0
3/3/2020,Q1,5,B,Sha Tau Kok,Departure,0,0,0,0
3/3/2020,Q1,5,B,Shenzhen Bay,Arrival,1479,165,3,1647
3/3/2020,Q1,5,B,Shenzhen Bay,Departure,1970,793,667,3430
3/3/2020,Q1,5,B,China Ferry Terminal,Arrival,0,0,0,0
3/3/2020,Q1,5,B,China Ferry Terminal,Departure,0,0,0,0
3/3/2020,Q1,5,B,Harbour Control,Arrival,0,0,0,0
3/3/2020,Q1,5,B,Harbour Control,Departure,0,0,0,0
3/3/2020,Q1,5,B,Kai Tak Cruise Terminal,Arrival,0,0,0,0
3/3/2020,Q1,5,B,Kai Tak Cruise Terminal,Departure,0,0,0,0
3/3/2020,Q1,5,B,Macau Ferry Terminal,Arrival,0,0,0,0
3/3/2020,Q1,5,B,Macau Ferry Terminal,Departure,0,0,0,0
3/3/2020,Q1,5,B,Tuen Mun Ferry Terminal,Arrival,0,0,0,0
3/3/2020,Q1,5,B,Tuen Mun Ferry Terminal,Departure,0,0,0,0
3/4/2020,Q1,5,B,Airport,Arrival,7590,772,1847,10209
3/4/2020,Q1,5,B,Airport,Departure,7170,213,1123,8506
3/4/2020,Q1,5,B,Express Rail Link West Kowloon,Arrival,0,0,0,0
3/4/2020,Q1,5,B,Express Rail Link West Kowloon,Departure,0,0,0,0
3/4/2020,Q1,5,B,Hung Hom,Arrival,0,0,0,0
3/4/2020,Q1,5,B,Hung Hom,Departure,0,0,0,0
3/4/2020,Q1,5,B,Lo Wu,Arrival,0,0,0,0
3/4/2020,Q1,5,B,Lo Wu,Departure,0,0,0,0
3/4/2020,Q1,5,B,Lok Ma Chau Spur Line,Arrival,0,0,0,0
3/4/2020,Q1,5,B,Lok Ma Chau Spur Line,Departure,0,0,0,0
3/4/2020,Q1,5,B,Hong Kong-Zhuhai-Macao Bridge,Arrival,4368,9,753,5130
3/4/2020,Q1,5,B,Hong Kong-Zhuhai-Macao Bridge,Departure,4539,92,802,5433
3/4/2020,Q1,5,B,Lok Ma Chau,Arrival,0,0,0,0
3/4/2020,Q1,5,B,Lok Ma Chau,Departure,0,0,0,0
3/4/2020,Q1,5,B,Man Kam To,Arrival,0,0,0,0
3/4/2020,Q1,5,B,Man Kam To,Departure,0,0,0,0
3/4/2020,Q1,5,B,Sha Tau Kok,Arrival,0,0,0,0
3/4/2020,Q1,5,B,Sha Tau Kok,Departure,0,0,0,0
3/4/2020,Q1,5,B,Shenzhen Bay,Arrival,1306,192,7,1505
3/4/2020,Q1,5,B,Shenzhen Bay,Departure,1684,806,664,3154
3/4/2020,Q1,5,B,China Ferry Terminal,Arrival,0,0,0,0
3/4/2020,Q1,5,B,China Ferry Terminal,Departure,0,0,0,0
3/4/2020,Q1,5,B,Harbour Control,Arrival,0,0,0,0
3/4/2020,Q1,5,B,Harbour Control,Departure,0,0,0,0
3/4/2020,Q1,5,B,Kai Tak Cruise Terminal,Arrival,0,0,0,0
3/4/2020,Q1,5,B,Kai Tak Cruise Terminal,Departure,0,0,0,0
3/4/2020,Q1,5,B,Macau Ferry Terminal,Arrival,0,0,0,0
3/4/2020,Q1,5,B,Macau Ferry Terminal,Departure,0,0,0,0
3/4/2020,Q1,5,B,Tuen Mun Ferry Terminal,Arrival,0,0,0,0
3/4/2020,Q1,5,B,Tuen Mun Ferry Terminal,Departure,0,0,0,0
3/5/2020,Q1,5,B,Airport,Arrival,7074,673,1749,9496
3/5/2020,Q1,5,B,Airport,Departure,8141,190,1289,9620
3/5/2020,Q1,5,B,Express Rail Link West Kowloon,Arrival,0,0,0,0
3/5/2020,Q1,5,B,Express Rail Link West Kowloon,Departure,0,0,0,0
3/5/2020,Q1,5,B,Hung Hom,Arrival,0,0,0,0
3/5/2020,Q1,5,B,Hung Hom,Departure,0,0,0,0
3/5/2020,Q1,5,B,Lo Wu,Arrival,0,0,0,0
3/5/2020,Q1,5,B,Lo Wu,Departure,0,0,0,0
3/5/2020,Q1,5,B,Lok Ma Chau Spur Line,Arrival,0,0,0,0
3/5/2020,Q1,5,B,Lok Ma Chau Spur Line,Departure,0,0,0,0
3/5/2020,Q1,5,B,Hong Kong-Zhuhai-Macao Bridge,Arrival,4752,17,782,5551
3/5/2020,Q1,5,B,Hong Kong-Zhuhai-Macao Bridge,Departure,4999,96,776,5871
3/5/2020,Q1,5,B,Lok Ma Chau,Arrival,0,0,0,0
3/5/2020,Q1,5,B,Lok Ma Chau,Departure,0,0,0,0
3/5/2020,Q1,5,B,Man Kam To,Arrival,0,0,0,0
3/5/2020,Q1,5,B,Man Kam To,Departure,0,0,0,0
3/5/2020,Q1,5,B,Sha Tau Kok,Arrival,0,0,0,0
3/5/2020,Q1,5,B,Sha Tau Kok,Departure,0,0,0,0
3/5/2020,Q1,5,B,Shenzhen Bay,Arrival,1419,226,3,1648
3/5/2020,Q1,5,B,Shenzhen Bay,Departure,1589,767,638,2994
3/5/2020,Q1,5,B,China Ferry Terminal,Arrival,0,0,0,0
3/5/2020,Q1,5,B,China Ferry Terminal,Departure,0,0,0,0
3/5/2020,Q1,5,B,Harbour Control,Arrival,0,0,0,0
3/5/2020,Q1,5,B,Harbour Control,Departure,0,0,0,0
3/5/2020,Q1,5,B,Kai Tak Cruise Terminal,Arrival,0,0,0,0
3/5/2020,Q1,5,B,Kai Tak Cruise Terminal,Departure,0,0,0,0
3/5/2020,Q1,5,B,Macau Ferry Terminal,Arrival,0,0,0,0
3/5/2020,Q1,5,B,Macau Ferry Terminal,Departure,0,0,0,0
3/5/2020,Q1,5,B,Tuen Mun Ferry Terminal,Arrival,0,0,0,0
3/5/2020,Q1,5,B,Tuen Mun Ferry Terminal,Departure,0,0,0,0
3/6/2020,Q1,5,B,Airport,Arrival,7474,705,1877,10056
3/6/2020,Q1,5,B,Airport,Departure,8746,215,1150,10111
3/6/2020,Q1,5,B,Express Rail Link West Kowloon,Arrival,0,0,0,0
3/6/2020,Q1,5,B,Express Rail Link West Kowloon,Departure,0,0,0,0
3/6/2020,Q1,5,B,Hung Hom,Arrival,0,0,0,0
3/6/2020,Q1,5,B,Hung Hom,Departure,0,0,0,0
3/6/2020,Q1,5,B,Lo Wu,Arrival,0,0,0,0
3/6/2020,Q1,5,B,Lo Wu,Departure,0,0,0,0
3/6/2020,Q1,5,B,Lok Ma Chau Spur Line,Arrival,0,0,0,0
3/6/2020,Q1,5,B,Lok Ma Chau Spur Line,Departure,0,0,0,0
3/6/2020,Q1,5,B,Hong Kong-Zhuhai-Macao Bridge,Arrival,6255,22,894,7171
3/6/2020,Q1,5,B,Hong Kong-Zhuhai-Macao Bridge,Departure,6030,116,768,6914
3/6/2020,Q1,5,B,Lok Ma Chau,Arrival,0,0,0,0
3/6/2020,Q1,5,B,Lok Ma Chau,Departure,0,0,0,0
3/6/2020,Q1,5,B,Man Kam To,Arrival,0,0,0,0
3/6/2020,Q1,5,B,Man Kam To,Departure,0,0,0,0
3/6/2020,Q1,5,B,Sha Tau Kok,Arrival,0,0,0,0
3/6/2020,Q1,5,B,Sha Tau Kok,Departure,0,0,0,0
3/6/2020,Q1,5,B,Shenzhen Bay,Arrival,1425,251,8,1684
3/6/2020,Q1,5,B,Shenzhen Bay,Departure,1550,734,544,2828
3/6/2020,Q1,5,B,China Ferry Terminal,Arrival,0,0,0,0
3/6/2020,Q1,5,B,China Ferry Terminal,Departure,0,0,0,0
3/6/2020,Q1,5,B,Harbour Control,Arrival,0,0,0,0
3/6/2020,Q1,5,B,Harbour Control,Departure,0,0,0,0
3/6/2020,Q1,5,B,Kai Tak Cruise Terminal,Arrival,0,0,0,0
3/6/2020,Q1,5,B,Kai Tak Cruise Terminal,Departure,0,0,0,0
3/6/2020,Q1,5,B,Macau Ferry Terminal,Arrival,0,0,0,0
3/6/2020,Q1,5,B,Macau Ferry Terminal,Departure,0,0,0,0
3/6/2020,Q1,5,B,Tuen Mun Ferry Terminal,Arrival,0,0,0,0
3/6/2020,Q1,5,B,Tuen Mun Ferry Terminal,Departure,0,0,0,0
3/7/2020,Q1,5,B,Airport,Arrival,8659,795,1919,11373
3/7/2020,Q1,5,B,Airport,Departure,7316,216,1398,8930
3/7/2020,Q1,5,B,Express Rail Link West Kowloon,Arrival,0,0,0,0
3/7/2020,Q1,5,B,Express Rail Link West Kowloon,Departure,0,0,0,0
3/7/2020,Q1,5,B,Hung Hom,Arrival,0,0,0,0
3/7/2020,Q1,5,B,Hung Hom,Departure,0,0,0,0
3/7/2020,Q1,5,B,Lo Wu,Arrival,0,0,0,0
3/7/2020,Q1,5,B,Lo Wu,Departure,0,0,0,0
3/7/2020,Q1,5,B,Lok Ma Chau Spur Line,Arrival,0,0,0,0
3/7/2020,Q1,5,B,Lok Ma Chau Spur Line,Departure,0,0,0,0
3/7/2020,Q1,5,B,Hong Kong-Zhuhai-Macao Bridge,Arrival,5935,26,973,6934
3/7/2020,Q1,5,B,Hong Kong-Zhuhai-Macao Bridge,Departure,6440,132,903,7475
3/7/2020,Q1,5,B,Lok Ma Chau,Arrival,0,0,0,0
3/7/2020,Q1,5,B,Lok Ma Chau,Departure,0,0,0,0
3/7/2020,Q1,5,B,Man Kam To,Arrival,0,0,0,0
3/7/2020,Q1,5,B,Man Kam To,Departure,0,0,0,0
3/7/2020,Q1,5,B,Sha Tau Kok,Arrival,0,0,0,0
3/7/2020,Q1,5,B,Sha Tau Kok,Departure,0,0,0,0
3/7/2020,Q1,5,B,Shenzhen Bay,Arrival,1180,269,2,1451
3/7/2020,Q1,5,B,Shenzhen Bay,Departure,1380,856,622,2858
3/7/2020,Q1,5,B,China Ferry Terminal,Arrival,0,0,0,0
3/7/2020,Q1,5,B,China Ferry Terminal,Departure,0,0,0,0
3/7/2020,Q1,5,B,Harbour Control,Arrival,0,0,0,0
3/7/2020,Q1,5,B,Harbour Control,Departure,0,0,0,0
3/7/2020,Q1,5,B,Kai Tak Cruise Terminal,Arrival,0,0,0,0
3/7/2020,Q1,5,B,Kai Tak Cruise Terminal,Departure,0,0,0,0
3/7/2020,Q1,5,B,Macau Ferry Terminal,Arrival,0,0,0,0
3/7/2020,Q1,5,B,Macau Ferry Terminal,Departure,0,0,0,0
3/7/2020,Q1,5,B,Tuen Mun Ferry Terminal,Arrival,0,0,0,0
3/7/2020,Q1,5,B,Tuen Mun Ferry Terminal,Departure,0,0,0,0
3/8/2020,Q1,5,B,Airport,Arrival,12538,730,1833,15101
3/8/2020,Q1,5,B,Airport,Departure,6371,276,1376,8023
3/8/2020,Q1,5,B,Express Rail Link West Kowloon,Arrival,0,0,0,0
3/8/2020,Q1,5,B,Express Rail Link West Kowloon,Departure,0,0,0,0
3/8/2020,Q1,5,B,Hung Hom,Arrival,0,0,0,0
3/8/2020,Q1,5,B,Hung Hom,Departure,0,0,0,0
3/8/2020,Q1,5,B,Lo Wu,Arrival,0,0,0,0
3/8/2020,Q1,5,B,Lo Wu,Departure,0,0,0,0
3/8/2020,Q1,5,B,Lok Ma Chau Spur Line,Arrival,0,0,0,0
3/8/2020,Q1,5,B,Lok Ma Chau Spur Line,Departure,0,0,0,0
3/8/2020,Q1,5,B,Hong Kong-Zhuhai-Macao Bridge,Arrival,6331,23,806,7160
3/8/2020,Q1,5,B,Hong Kong-Zhuhai-Macao Bridge,Departure,5935,109,1127,7171
3/8/2020,Q1,5,B,Lok Ma Chau,Arrival,0,0,0,0
3/8/2020,Q1,5,B,Lok Ma Chau,Departure,0,0,0,0
3/8/2020,Q1,5,B,Man Kam To,Arrival,0,0,0,0
3/8/2020,Q1,5,B,Man Kam To,Departure,0,0,0,0
3/8/2020,Q1,5,B,Sha Tau Kok,Arrival,0,0,0,0
3/8/2020,Q1,5,B,Sha Tau Kok,Departure,0,0,0,0
3/8/2020,Q1,5,B,Shenzhen Bay,Arrival,1386,252,9,1647
3/8/2020,Q1,5,B,Shenzhen Bay,Departure,1547,897,678,3122
3/8/2020,Q1,5,B,China Ferry Terminal,Arrival,0,0,0,0
3/8/2020,Q1,5,B,China Ferry Terminal,Departure,0,0,0,0
3/8/2020,Q1,5,B,Harbour Control,Arrival,0,0,0,0
3/8/2020,Q1,5,B,Harbour Control,Departure,0,0,0,0
3/8/2020,Q1,5,B,Kai Tak Cruise Terminal,Arrival,0,0,0,0
3/8/2020,Q1,5,B,Kai Tak Cruise Terminal,Departure,0,0,0,0
3/8/2020,Q1,5,B,Macau Ferry Terminal,Arrival,0,0,0,0
3/8/2020,Q1,5,B,Macau Ferry Terminal,Departure,0,0,0,0
3/8/2020,Q1,5,B,Tuen Mun Ferry Terminal,Arrival,0,0,0,0
3/8/2020,Q1,5,B,Tuen Mun Ferry Terminal,Departure,0,0,0,0
3/9/2020,Q1,5,B,Airport,Arrival,8304,706,1623,10633
3/9/2020,Q1,5,B,Airport,Departure,4721,139,970,5830
3/9/2020,Q1,5,B,Express Rail Link West Kowloon,Arrival,0,0,0,0
3/9/2020,Q1,5,B,Express Rail Link West Kowloon,Departure,0,0,0,0
3/9/2020,Q1,5,B,Hung Hom,Arrival,0,0,0,0
3/9/2020,Q1,5,B,Hung Hom,Departure,0,0,0,0
3/9/2020,Q1,5,B,Lo Wu,Arrival,0,0,0,0
3/9/2020,Q1,5,B,Lo Wu,Departure,0,0,0,0
3/9/2020,Q1,5,B,Lok Ma Chau Spur Line,Arrival,0,0,0,0
3/9/2020,Q1,5,B,Lok Ma Chau Spur Line,Departure,0,0,0,0
3/9/2020,Q1,5,B,Hong Kong-Zhuhai-Macao Bridge,Arrival,5638,16,805,6459
3/9/2020,Q1,5,B,Hong Kong-Zhuhai-Macao Bridge,Departure,6224,133,929,7286
3/9/2020,Q1,5,B,Lok Ma Chau,Arrival,0,0,0,0
3/9/2020,Q1,5,B,Lok Ma Chau,Departure,0,0,0,0
3/9/2020,Q1,5,B,Man Kam To,Arrival,0,0,0,0
3/9/2020,Q1,5,B,Man Kam To,Departure,0,0,0,0
3/9/2020,Q1,5,B,Sha Tau Kok,Arrival,0,0,0,0
3/9/2020,Q1,5,B,Sha Tau Kok,Departure,0,0,0,0
3/9/2020,Q1,5,B,Shenzhen Bay,Arrival,1632,233,10,1875
3/9/2020,Q1,5,B,Shenzhen Bay,Departure,2197,774,592,3563
3/9/2020,Q1,5,B,China Ferry Terminal,Arrival,0,0,0,0
3/9/2020,Q1,5,B,China Ferry Terminal,Departure,0,0,0,0
3/9/2020,Q1,5,B,Harbour Control,Arrival,0,0,0,0
3/9/2020,Q1,5,B,Harbour Control,Departure,0,0,0,0
3/9/2020,Q1,5,B,Kai Tak Cruise Terminal,Arrival,0,0,0,0
3/9/2020,Q1,5,B,Kai Tak Cruise Terminal,Departure,0,0,0,0
3/9/2020,Q1,5,B,Macau Ferry Terminal,Arrival,0,0,0,0
3/9/2020,Q1,5,B,Macau Ferry Terminal,Departure,0,0,0,0
3/9/2020,Q1,5,B,Tuen Mun Ferry Terminal,Arrival,0,0,0,0
3/9/2020,Q1,5,B,Tuen Mun Ferry Terminal,Departure,0,0,0,0
3/10/2020,Q1,5,B,Airport,Arrival,7051,663,1531,9245
3/10/2020,Q1,5,B,Airport,Departure,3802,142,914,4858
3/10/2020,Q1,5,B,Express Rail Link West Kowloon,Arrival,0,0,0,0
3/10/2020,Q1,5,B,Express Rail Link West Kowloon,Departure,0,0,0,0
3/10/2020,Q1,5,B,Hung Hom,Arrival,0,0,0,0
3/10/2020,Q1,5,B,Hung Hom,Departure,0,0,0,0
3/10/2020,Q1,5,B,Lo Wu,Arrival,0,0,0,0
3/10/2020,Q1,5,B,Lo Wu,Departure,0,0,0,0
3/10/2020,Q1,5,B,Lok Ma Chau Spur Line,Arrival,0,0,0,0
3/10/2020,Q1,5,B,Lok Ma Chau Spur Line,Departure,0,0,0,0
3/10/2020,Q1,5,B,Hong Kong-Zhuhai-Macao Bridge,Arrival,5366,31,757,6154
3/10/2020,Q1,5,B,Hong Kong-Zhuhai-Macao Bridge,Departure,5687,84,900,6671
3/10/2020,Q1,5,B,Lok Ma Chau,Arrival,0,0,0,0
3/10/2020,Q1,5,B,Lok Ma Chau,Departure,0,0,0,0
3/10/2020,Q1,5,B,Man Kam To,Arrival,0,0,0,0
3/10/2020,Q1,5,B,Man Kam To,Departure,0,0,0,0
3/10/2020,Q1,5,B,Sha Tau Kok,Arrival,0,0,0,0
3/10/2020,Q1,5,B,Sha Tau Kok,Departure,0,0,0,0
3/10/2020,Q1,5,B,Shenzhen Bay,Arrival,1491,212,5,1708
3/10/2020,Q1,5,B,Shenzhen Bay,Departure,1762,802,432,2996
3/10/2020,Q1,5,B,China Ferry Terminal,Arrival,0,0,0,0
3/10/2020,Q1,5,B,China Ferry Terminal,Departure,0,0,0,0
3/10/2020,Q1,5,B,Harbour Control,Arrival,0,0,0,0
3/10/2020,Q1,5,B,Harbour Control,Departure,0,0,0,0
3/10/2020,Q1,5,B,Kai Tak Cruise Terminal,Arrival,0,0,0,0
3/10/2020,Q1,5,B,Kai Tak Cruise Terminal,Departure,0,0,0,0
3/10/2020,Q1,5,B,Macau Ferry Terminal,Arrival,0,0,0,0
3/10/2020,Q1,5,B,Macau Ferry Terminal,Departure,0,0,0,0
3/10/2020,Q1,5,B,Tuen Mun Ferry Terminal,Arrival,0,0,0,0
3/10/2020,Q1,5,B,Tuen Mun Ferry Terminal,Departure,0,0,0,0
3/11/2020,Q1,5,B,Airport,Arrival,7610,838,1539,9987
3/11/2020,Q1,5,B,Airport,Departure,3443,205,841,4489
3/11/2020,Q1,5,B,Express Rail Link West Kowloon,Arrival,0,0,0,0
3/11/2020,Q1,5,B,Express Rail Link West Kowloon,Departure,0,0,0,0
3/11/2020,Q1,5,B,Hung Hom,Arrival,0,0,0,0
3/11/2020,Q1,5,B,Hung Hom,Departure,0,0,0,0
3/11/2020,Q1,5,B,Lo Wu,Arrival,0,0,0,0
3/11/2020,Q1,5,B,Lo Wu,Departure,0,0,0,0
3/11/2020,Q1,5,B,Lok Ma Chau Spur Line,Arrival,0,0,0,0
3/11/2020,Q1,5,B,Lok Ma Chau Spur Line,Departure,0,0,0,0
3/11/2020,Q1,5,B,Hong Kong-Zhuhai-Macao Bridge,Arrival,5248,25,733,6006
3/11/2020,Q1,5,B,Hong Kong-Zhuhai-Macao Bridge,Departure,5258,122,765,6145
3/11/2020,Q1,5,B,Lok Ma Chau,Arrival,0,0,0,0
3/11/2020,Q1,5,B,Lok Ma Chau,Departure,0,0,0,0
3/11/2020,Q1,5,B,Man Kam To,Arrival,0,0,0,0
3/11/2020,Q1,5,B,Man Kam To,Departure,0,0,0,0
3/11/2020,Q1,5,B,Sha Tau Kok,Arrival,0,0,0,0
3/11/2020,Q1,5,B,Sha Tau Kok,Departure,0,0,0,0
3/11/2020,Q1,5,B,Shenzhen Bay,Arrival,1418,244,2,1664
3/11/2020,Q1,5,B,Shenzhen Bay,Departure,1632,866,443,2941
3/11/2020,Q1,5,B,China Ferry Terminal,Arrival,0,0,0,0
3/11/2020,Q1,5,B,China Ferry Terminal,Departure,0,0,0,0
3/11/2020,Q1,5,B,Harbour Control,Arrival,0,0,0,0
3/11/2020,Q1,5,B,Harbour Control,Departure,0,0,0,0
3/11/2020,Q1,5,B,Kai Tak Cruise Terminal,Arrival,0,0,0,0
3/11/2020,Q1,5,B,Kai Tak Cruise Terminal,Departure,0,0,0,0
3/11/2020,Q1,5,B,Macau Ferry Terminal,Arrival,0,0,0,0
3/11/2020,Q1,5,B,Macau Ferry Terminal,Departure,0,0,0,0
3/11/2020,Q1,5,B,Tuen Mun Ferry Terminal,Arrival,0,0,0,0
3/11/2020,Q1,5,B,Tuen Mun Ferry Terminal,Departure,0,0,0,0
3/12/2020,Q1,5,B,Airport,Arrival,6416,944,1426,8786
3/12/2020,Q1,5,B,Airport,Departure,4050,152,995,5197
3/12/2020,Q1,5,B,Express Rail Link West Kowloon,Arrival,0,0,0,0
3/12/2020,Q1,5,B,Express Rail Link West Kowloon,Departure,0,0,0,0
3/12/2020,Q1,5,B,Hung Hom,Arrival,0,0,0,0
3/12/2020,Q1,5,B,Hung Hom,Departure,0,0,0,0
3/12/2020,Q1,5,B,Lo Wu,Arrival,0,0,0,0
3/12/2020,Q1,5,B,Lo Wu,Departure,0,0,0,0
3/12/2020,Q1,5,B,Lok Ma Chau Spur Line,Arrival,0,0,0,0
3/12/2020,Q1,5,B,Lok Ma Chau Spur Line,Departure,0,0,0,0
3/12/2020,Q1,5,B,Hong Kong-Zhuhai-Macao Bridge,Arrival,5391,21,753,6165
3/12/2020,Q1,5,B,Hong Kong-Zhuhai-Macao Bridge,Departure,5753,177,790,6720
3/12/2020,Q1,5,B,Lok Ma Chau,Arrival,0,0,0,0
3/12/2020,Q1,5,B,Lok Ma Chau,Departure,0,0,0,0
3/12/2020,Q1,5,B,Man Kam To,Arrival,0,0,0,0
3/12/2020,Q1,5,B,Man Kam To,Departure,0,0,0,0
3/12/2020,Q1,5,B,Sha Tau Kok,Arrival,0,0,0,0
3/12/2020,Q1,5,B,Sha Tau Kok,Departure,0,0,0,0
3/12/2020,Q1,5,B,Shenzhen Bay,Arrival,1376,235,3,1614
3/12/2020,Q1,5,B,Shenzhen Bay,Departure,1602,887,417,2906
3/12/2020,Q1,5,B,China Ferry Terminal,Arrival,0,0,0,0
3/12/2020,Q1,5,B,China Ferry Terminal,Departure,0,0,0,0
3/12/2020,Q1,5,B,Harbour Control,Arrival,0,0,0,0
3/12/2020,Q1,5,B,Harbour Control,Departure,0,0,0,0
3/12/2020,Q1,5,B,Kai Tak Cruise Terminal,Arrival,0,0,0,0
3/12/2020,Q1,5,B,Kai Tak Cruise Terminal,Departure,0,0,0,0
3/12/2020,Q1,5,B,Macau Ferry Terminal,Arrival,0,0,0,0
3/12/2020,Q1,5,B,Macau Ferry Terminal,Departure,0,0,0,0
3/12/2020,Q1,5,B,Tuen Mun Ferry Terminal,Arrival,0,0,0,0
3/12/2020,Q1,5,B,Tuen Mun Ferry Terminal,Departure,0,0,0,0
3/13/2020,Q1,5,B,Airport,Arrival,6758,1075,1401,9234
3/13/2020,Q1,5,B,Airport,Departure,4435,269,1044,5748
3/13/2020,Q1,5,B,Express Rail Link West Kowloon,Arrival,0,0,0,0
3/13/2020,Q1,5,B,Express Rail Link West Kowloon,Departure,0,0,0,0
3/13/2020,Q1,5,B,Hung Hom,Arrival,0,0,0,0
3/13/2020,Q1,5,B,Hung Hom,Departure,0,0,0,0
3/13/2020,Q1,5,B,Lo Wu,Arrival,0,0,0,0
3/13/2020,Q1,5,B,Lo Wu,Departure,0,0,0,0
3/13/2020,Q1,5,B,Lok Ma Chau Spur Line,Arrival,0,0,0,0
3/13/2020,Q1,5,B,Lok Ma Chau Spur Line,Departure,0,0,0,0
3/13/2020,Q1,5,B,Hong Kong-Zhuhai-Macao Bridge,Arrival,6872,19,945,7836
3/13/2020,Q1,5,B,Hong Kong-Zhuhai-Macao Bridge,Departure,6694,142,939,7775
3/13/2020,Q1,5,B,Lok Ma Chau,Arrival,0,0,0,0
3/13/2020,Q1,5,B,Lok Ma Chau,Departure,0,0,0,0
3/13/2020,Q1,5,B,Man Kam To,Arrival,0,0,0,0
3/13/2020,Q1,5,B,Man Kam To,Departure,0,0,0,0
3/13/2020,Q1,5,B,Sha Tau Kok,Arrival,0,0,0,0
3/13/2020,Q1,5,B,Sha Tau Kok,Departure,0,0,0,0
3/13/2020,Q1,5,B,Shenzhen Bay,Arrival,1418,254,3,1675
3/13/2020,Q1,5,B,Shenzhen Bay,Departure,1520,1018,369,2907
3/13/2020,Q1,5,B,China Ferry Terminal,Arrival,0,0,0,0
3/13/2020,Q1,5,B,China Ferry Terminal,Departure,0,0,0,0
3/13/2020,Q1,5,B,Harbour Control,Arrival,0,0,0,0
3/13/2020,Q1,5,B,Harbour Control,Departure,0,0,0,0
3/13/2020,Q1,5,B,Kai Tak Cruise Terminal,Arrival,0,0,0,0
3/13/2020,Q1,5,B,Kai Tak Cruise Terminal,Departure,0,0,0,0
3/13/2020,Q1,5,B,Macau Ferry Terminal,Arrival,0,0,0,0
3/13/2020,Q1,5,B,Macau Ferry Terminal,Departure,0,0,0,0
3/13/2020,Q1,5,B,Tuen Mun Ferry Terminal,Arrival,0,0,0,0
3/13/2020,Q1,5,B,Tuen Mun Ferry Terminal,Departure,0,0,0,0
3/14/2020,Q1,5,B,Airport,Arrival,7513,1435,1587,10535
3/14/2020,Q1,5,B,Airport,Departure,3764,214,996,4974
3/14/2020,Q1,5,B,Express Rail Link West Kowloon,Arrival,0,0,0,0
3/14/2020,Q1,5,B,Express Rail Link West Kowloon,Departure,0,0,0,0
3/14/2020,Q1,5,B,Hung Hom,Arrival,0,0,0,0
3/14/2020,Q1,5,B,Hung Hom,Departure,0,0,0,0
3/14/2020,Q1,5,B,Lo Wu,Arrival,0,0,0,0
3/14/2020,Q1,5,B,Lo Wu,Departure,0,0,0,0
3/14/2020,Q1,5,B,Lok Ma Chau Spur Line,Arrival,0,0,0,0
3/14/2020,Q1,5,B,Lok Ma Chau Spur Line,Departure,0,0,0,0
3/14/2020,Q1,5,B,Hong Kong-Zhuhai-Macao Bridge,Arrival,6098,25,1075,7198
3/14/2020,Q1,5,B,Hong Kong-Zhuhai-Macao Bridge,Departure,7110,206,1126,8442
3/14/2020,Q1,5,B,Lok Ma Chau,Arrival,0,0,0,0
3/14/2020,Q1,5,B,Lok Ma Chau,Departure,0,0,0,0
3/14/2020,Q1,5,B,Man Kam To,Arrival,0,0,0,0
3/14/2020,Q1,5,B,Man Kam To,Departure,0,0,0,0
3/14/2020,Q1,5,B,Sha Tau Kok,Arrival,0,0,0,0
3/14/2020,Q1,5,B,Sha Tau Kok,Departure,0,0,0,0
3/14/2020,Q1,5,B,Shenzhen Bay,Arrival,1276,270,3,1549
3/14/2020,Q1,5,B,Shenzhen Bay,Departure,1560,1303,406,3269
3/14/2020,Q1,5,B,China Ferry Terminal,Arrival,0,0,0,0
3/14/2020,Q1,5,B,China Ferry Terminal,Departure,0,0,0,0
3/14/2020,Q1,5,B,Harbour Control,Arrival,0,0,0,0
3/14/2020,Q1,5,B,Harbour Control,Departure,0,0,0,0
3/14/2020,Q1,5,B,Kai Tak Cruise Terminal,Arrival,0,0,0,0
3/14/2020,Q1,5,B,Kai Tak Cruise Terminal,Departure,0,0,0,0
3/14/2020,Q1,5,B,Macau Ferry Terminal,Arrival,0,0,0,0
3/14/2020,Q1,5,B,Macau Ferry Terminal,Departure,0,0,0,0
3/14/2020,Q1,5,B,Tuen Mun Ferry Terminal,Arrival,0,0,0,0
3/14/2020,Q1,5,B,Tuen Mun Ferry Terminal,Departure,0,0,0,0
3/15/2020,Q1,5,B,Airport,Arrival,10027,1558,1950,13535
3/15/2020,Q1,5,B,Airport,Departure,2516,315,863,3694
3/15/2020,Q1,5,B,Express Rail Link West Kowloon,Arrival,0,0,0,0
3/15/2020,Q1,5,B,Express Rail Link West Kowloon,Departure,0,0,0,0
3/15/2020,Q1,5,B,Hung Hom,Arrival,0,0,0,0
3/15/2020,Q1,5,B,Hung Hom,Departure,0,0,0,0
3/15/2020,Q1,5,B,Lo Wu,Arrival,0,0,0,0
3/15/2020,Q1,5,B,Lo Wu,Departure,0,0,0,0
3/15/2020,Q1,5,B,Lok Ma Chau Spur Line,Arrival,0,0,0,0
3/15/2020,Q1,5,B,Lok Ma Chau Spur Line,Departure,0,0,0,0
3/15/2020,Q1,5,B,Hong Kong-Zhuhai-Macao Bridge,Arrival,8172,33,674,8879
3/15/2020,Q1,5,B,Hong Kong-Zhuhai-Macao Bridge,Departure,7405,194,1233,8832
3/15/2020,Q1,5,B,Lok Ma Chau,Arrival,0,0,0,0
3/15/2020,Q1,5,B,Lok Ma Chau,Departure,0,0,0,0
3/15/2020,Q1,5,B,Man Kam To,Arrival,0,0,0,0
3/15/2020,Q1,5,B,Man Kam To,Departure,0,0,0,0
3/15/2020,Q1,5,B,Sha Tau Kok,Arrival,0,0,0,0
3/15/2020,Q1,5,B,Sha Tau Kok,Departure,0,0,0,0
3/15/2020,Q1,5,B,Shenzhen Bay,Arrival,1745,351,18,2114
3/15/2020,Q1,5,B,Shenzhen Bay,Departure,1628,1565,632,3825
3/15/2020,Q1,5,B,China Ferry Terminal,Arrival,0,0,0,0
3/15/2020,Q1,5,B,China Ferry Terminal,Departure,0,0,0,0
3/15/2020,Q1,5,B,Harbour Control,Arrival,0,0,0,0
3/15/2020,Q1,5,B,Harbour Control,Departure,0,0,0,0
3/15/2020,Q1,5,B,Kai Tak Cruise Terminal,Arrival,0,0,0,0
3/15/2020,Q1,5,B,Kai Tak Cruise Terminal,Departure,0,0,0,0
3/15/2020,Q1,5,B,Macau Ferry Terminal,Arrival,0,0,0,0
3/15/2020,Q1,5,B,Macau Ferry Terminal,Departure,0,0,0,0
3/15/2020,Q1,5,B,Tuen Mun Ferry Terminal,Arrival,0,0,0,0
3/15/2020,Q1,5,B,Tuen Mun Ferry Terminal,Departure,0,0,0,0
3/16/2020,Q1,5,B,Airport,Arrival,8498,1662,2038,12198
3/16/2020,Q1,5,B,Airport,Departure,2117,382,896,3395
3/16/2020,Q1,5,B,Express Rail Link West Kowloon,Arrival,0,0,0,0
3/16/2020,Q1,5,B,Express Rail Link West Kowloon,Departure,0,0,0,0
3/16/2020,Q1,5,B,Hung Hom,Arrival,0,0,0,0
3/16/2020,Q1,5,B,Hung Hom,Departure,0,0,0,0
3/16/2020,Q1,5,B,Lo Wu,Arrival,0,0,0,0
3/16/2020,Q1,5,B,Lo Wu,Departure,0,0,0,0
3/16/2020,Q1,5,B,Lok Ma Chau Spur Line,Arrival,0,0,0,0
3/16/2020,Q1,5,B,Lok Ma Chau Spur Line,Departure,0,0,0,0
3/16/2020,Q1,5,B,Hong Kong-Zhuhai-Macao Bridge,Arrival,6258,28,792,7078
3/16/2020,Q1,5,B,Hong Kong-Zhuhai-Macao Bridge,Departure,6782,314,1408,8504
3/16/2020,Q1,5,B,Lok Ma Chau,Arrival,0,0,0,0
3/16/2020,Q1,5,B,Lok Ma Chau,Departure,0,0,0,0
3/16/2020,Q1,5,B,Man Kam To,Arrival,0,0,0,0
3/16/2020,Q1,5,B,Man Kam To,Departure,0,0,0,0
3/16/2020,Q1,5,B,Sha Tau Kok,Arrival,0,0,0,0
3/16/2020,Q1,5,B,Sha Tau Kok,Departure,0,0,0,0
3/16/2020,Q1,5,B,Shenzhen Bay,Arrival,1878,326,8,2212
3/16/2020,Q1,5,B,Shenzhen Bay,Departure,2182,1450,593,4225
3/16/2020,Q1,5,B,China Ferry Terminal,Arrival,0,0,0,0
3/16/2020,Q1,5,B,China Ferry Terminal,Departure,0,0,0,0
3/16/2020,Q1,5,B,Harbour Control,Arrival,0,0,0,0
3/16/2020,Q1,5,B,Harbour Control,Departure,0,0,0,0
3/16/2020,Q1,5,B,Kai Tak Cruise Terminal,Arrival,0,0,0,0
3/16/2020,Q1,5,B,Kai Tak Cruise Terminal,Departure,0,0,0,0
3/16/2020,Q1,5,B,Macau Ferry Terminal,Arrival,0,0,0,0
3/16/2020,Q1,5,B,Macau Ferry Terminal,Departure,0,0,0,0
3/16/2020,Q1,5,B,Tuen Mun Ferry Terminal,Arrival,0,0,0,0
3/16/2020,Q1,5,B,Tuen Mun Ferry Terminal,Departure,0,0,0,0
3/17/2020,Q1,5,B,Airport,Arrival,7472,1702,1272,10446
3/17/2020,Q1,5,B,Airport,Departure,1483,339,666,2488
3/17/2020,Q1,5,B,Express Rail Link West Kowloon,Arrival,0,0,0,0
3/17/2020,Q1,5,B,Express Rail Link West Kowloon,Departure,0,0,0,0
3/17/2020,Q1,5,B,Hung Hom,Arrival,0,0,0,0
3/17/2020,Q1,5,B,Hung Hom,Departure,0,0,0,0
3/17/2020,Q1,5,B,Lo Wu,Arrival,0,0,0,0
3/17/2020,Q1,5,B,Lo Wu,Departure,0,0,0,0
3/17/2020,Q1,5,B,Lok Ma Chau Spur Line,Arrival,0,0,0,0
3/17/2020,Q1,5,B,Lok Ma Chau Spur Line,Departure,0,0,0,0
3/17/2020,Q1,5,B,Hong Kong-Zhuhai-Macao Bridge,Arrival,5812,21,753,6586
3/17/2020,Q1,5,B,Hong Kong-Zhuhai-Macao Bridge,Departure,5791,287,979,7057
3/17/2020,Q1,5,B,Lok Ma Chau,Arrival,0,0,0,0
3/17/2020,Q1,5,B,Lok Ma Chau,Departure,0,0,0,0
3/17/2020,Q1,5,B,Man Kam To,Arrival,0,0,0,0
3/17/2020,Q1,5,B,Man Kam To,Departure,0,0,0,0
3/17/2020,Q1,5,B,Sha Tau Kok,Arrival,0,0,0,0
3/17/2020,Q1,5,B,Sha Tau Kok,Departure,0,0,0,0
3/17/2020,Q1,5,B,Shenzhen Bay,Arrival,1393,257,4,1654
3/17/2020,Q1,5,B,Shenzhen Bay,Departure,1672,1420,446,3538
3/17/2020,Q1,5,B,China Ferry Terminal,Arrival,0,0,0,0
3/17/2020,Q1,5,B,China Ferry Terminal,Departure,0,0,0,0
3/17/2020,Q1,5,B,Harbour Control,Arrival,0,0,0,0
3/17/2020,Q1,5,B,Harbour Control,Departure,0,0,0,0
3/17/2020,Q1,5,B,Kai Tak Cruise Terminal,Arrival,0,0,0,0
3/17/2020,Q1,5,B,Kai Tak Cruise Terminal,Departure,0,0,0,0
3/17/2020,Q1,5,B,Macau Ferry Terminal,Arrival,0,0,0,0
3/17/2020,Q1,5,B,Macau Ferry Terminal,Departure,0,0,0,0
3/17/2020,Q1,5,B,Tuen Mun Ferry Terminal,Arrival,0,0,0,0
3/17/2020,Q1,5,B,Tuen Mun Ferry Terminal,Departure,0,0,0,0
3/18/2020,Q1,5,B,Airport,Arrival,9616,2027,1309,12952
3/18/2020,Q1,5,B,Airport,Departure,1041,337,615,1993
3/18/2020,Q1,5,B,Express Rail Link West Kowloon,Arrival,0,0,0,0
3/18/2020,Q1,5,B,Express Rail Link West Kowloon,Departure,0,0,0,0
3/18/2020,Q1,5,B,Hung Hom,Arrival,0,0,0,0
3/18/2020,Q1,5,B,Hung Hom,Departure,0,0,0,0
3/18/2020,Q1,5,B,Lo Wu,Arrival,0,0,0,0
3/18/2020,Q1,5,B,Lo Wu,Departure,0,0,0,0
3/18/2020,Q1,5,B,Lok Ma Chau Spur Line,Arrival,0,0,0,0
3/18/2020,Q1,5,B,Lok Ma Chau Spur Line,Departure,0,0,0,0
3/18/2020,Q1,5,B,Hong Kong-Zhuhai-Macao Bridge,Arrival,5266,37,580,5883
3/18/2020,Q1,5,B,Hong Kong-Zhuhai-Macao Bridge,Departure,4850,334,792,5976
3/18/2020,Q1,5,B,Lok Ma Chau,Arrival,0,0,0,0
3/18/2020,Q1,5,B,Lok Ma Chau,Departure,0,0,0,0
3/18/2020,Q1,5,B,Man Kam To,Arrival,0,0,0,0
3/18/2020,Q1,5,B,Man Kam To,Departure,0,0,0,0
3/18/2020,Q1,5,B,Sha Tau Kok,Arrival,0,0,0,0
3/18/2020,Q1,5,B,Sha Tau Kok,Departure,0,0,0,0
3/18/2020,Q1,5,B,Shenzhen Bay,Arrival,1394,344,10,1748
3/18/2020,Q1,5,B,Shenzhen Bay,Departure,1570,1734,360,3664
3/18/2020,Q1,5,B,China Ferry Terminal,Arrival,0,0,0,0
3/18/2020,Q1,5,B,China Ferry Terminal,Departure,0,0,0,0
3/18/2020,Q1,5,B,Harbour Control,Arrival,0,0,0,0
3/18/2020,Q1,5,B,Harbour Control,Departure,0,0,0,0
3/18/2020,Q1,5,B,Kai Tak Cruise Terminal,Arrival,0,0,0,0
3/18/2020,Q1,5,B,Kai Tak Cruise Terminal,Departure,0,0,0,0
3/18/2020,Q1,5,B,Macau Ferry Terminal,Arrival,0,0,0,0
3/18/2020,Q1,5,B,Macau Ferry Terminal,Departure,0,0,0,0
3/18/2020,Q1,5,B,Tuen Mun Ferry Terminal,Arrival,0,0,0,0
3/18/2020,Q1,5,B,Tuen Mun Ferry Terminal,Departure,0,0,0,0
3/19/2020,Q1,5,B,Airport,Arrival,6138,37,596,6771
3/19/2020,Q1,5,B,Airport,Departure,1110,160,519,1789
3/19/2020,Q1,5,B,Express Rail Link West Kowloon,Arrival,0,0,0,0
3/19/2020,Q1,5,B,Express Rail Link West Kowloon,Departure,0,0,0,0
3/19/2020,Q1,5,B,Hung Hom,Arrival,0,0,0,0
3/19/2020,Q1,5,B,Hung Hom,Departure,0,0,0,0
3/19/2020,Q1,5,B,Lo Wu,Arrival,0,0,0,0
3/19/2020,Q1,5,B,Lo Wu,Departure,0,0,0,0
3/19/2020,Q1,5,B,Lok Ma Chau Spur Line,Arrival,0,0,0,0
3/19/2020,Q1,5,B,Lok Ma Chau Spur Line,Departure,0,0,0,0
3/19/2020,Q1,5,B,Hong Kong-Zhuhai-Macao Bridge,Arrival,4687,22,352,5061
3/19/2020,Q1,5,B,Hong Kong-Zhuhai-Macao Bridge,Departure,4824,46,423,5293
3/19/2020,Q1,5,B,Lok Ma Chau,Arrival,0,0,0,0
3/19/2020,Q1,5,B,Lok Ma Chau,Departure,0,0,0,0
3/19/2020,Q1,5,B,Man Kam To,Arrival,0,0,0,0
3/19/2020,Q1,5,B,Man Kam To,Departure,0,0,0,0
3/19/2020,Q1,5,B,Sha Tau Kok,Arrival,0,0,0,0
3/19/2020,Q1,5,B,Sha Tau Kok,Departure,0,0,0,0
3/19/2020,Q1,5,B,Shenzhen Bay,Arrival,1099,184,3,1286
3/19/2020,Q1,5,B,Shenzhen Bay,Departure,1449,458,244,2151
3/19/2020,Q1,5,B,China Ferry Terminal,Arrival,0,0,0,0
3/19/2020,Q1,5,B,China Ferry Terminal,Departure,0,0,0,0
3/19/2020,Q1,5,B,Harbour Control,Arrival,0,0,0,0
3/19/2020,Q1,5,B,Harbour Control,Departure,0,0,0,0
3/19/2020,Q1,5,B,Kai Tak Cruise Terminal,Arrival,0,0,0,0
3/19/2020,Q1,5,B,Kai Tak Cruise Terminal,Departure,0,0,0,0
3/19/2020,Q1,5,B,Macau Ferry Terminal,Arrival,0,0,0,0
3/19/2020,Q1,5,B,Macau Ferry Terminal,Departure,0,0,0,0
3/19/2020,Q1,5,B,Tuen Mun Ferry Terminal,Arrival,0,0,0,0
3/19/2020,Q1,5,B,Tuen Mun Ferry Terminal,Departure,0,0,0,0
3/20/2020,Q1,5,B,Airport,Arrival,6427,44,603,7074
3/20/2020,Q1,5,B,Airport,Departure,1190,54,445,1689
3/20/2020,Q1,5,B,Express Rail Link West Kowloon,Arrival,0,0,0,0
3/20/2020,Q1,5,B,Express Rail Link West Kowloon,Departure,0,0,0,0
3/20/2020,Q1,5,B,Hung Hom,Arrival,0,0,0,0
3/20/2020,Q1,5,B,Hung Hom,Departure,0,0,0,0
3/20/2020,Q1,5,B,Lo Wu,Arrival,0,0,0,0
3/20/2020,Q1,5,B,Lo Wu,Departure,0,0,0,0
3/20/2020,Q1,5,B,Lok Ma Chau Spur Line,Arrival,0,0,0,0
3/20/2020,Q1,5,B,Lok Ma Chau Spur Line,Departure,0,0,0,0
3/20/2020,Q1,5,B,Hong Kong-Zhuhai-Macao Bridge,Arrival,5732,18,458,6208
3/20/2020,Q1,5,B,Hong Kong-Zhuhai-Macao Bridge,Departure,5426,48,691,6165
3/20/2020,Q1,5,B,Lok Ma Chau,Arrival,0,0,0,0
3/20/2020,Q1,5,B,Lok Ma Chau,Departure,0,0,0,0
3/20/2020,Q1,5,B,Man Kam To,Arrival,0,0,0,0
3/20/2020,Q1,5,B,Man Kam To,Departure,0,0,0,0
3/20/2020,Q1,5,B,Sha Tau Kok,Arrival,0,0,0,0
3/20/2020,Q1,5,B,Sha Tau Kok,Departure,0,0,0,0
3/20/2020,Q1,5,B,Shenzhen Bay,Arrival,1328,245,3,1576
3/20/2020,Q1,5,B,Shenzhen Bay,Departure,1404,401,176,1981
3/20/2020,Q1,5,B,China Ferry Terminal,Arrival,0,0,0,0
3/20/2020,Q1,5,B,China Ferry Terminal,Departure,0,0,0,0
3/20/2020,Q1,5,B,Harbour Control,Arrival,0,0,0,0
3/20/2020,Q1,5,B,Harbour Control,Departure,0,0,0,0
3/20/2020,Q1,5,B,Kai Tak Cruise Terminal,Arrival,0,0,0,0
3/20/2020,Q1,5,B,Kai Tak Cruise Terminal,Departure,0,0,0,0
3/20/2020,Q1,5,B,Macau Ferry Terminal,Arrival,0,0,0,0
3/20/2020,Q1,5,B,Macau Ferry Terminal,Departure,0,0,0,0
3/20/2020,Q1,5,B,Tuen Mun Ferry Terminal,Arrival,0,0,0,0
3/20/2020,Q1,5,B,Tuen Mun Ferry Terminal,Departure,0,0,0,0
3/21/2020,Q1,5,B,Airport,Arrival,6547,43,526,7116
3/21/2020,Q1,5,B,Airport,Departure,844,39,320,1203
3/21/2020,Q1,5,B,Express Rail Link West Kowloon,Arrival,0,0,0,0
3/21/2020,Q1,5,B,Express Rail Link West Kowloon,Departure,0,0,0,0
3/21/2020,Q1,5,B,Hung Hom,Arrival,0,0,0,0
3/21/2020,Q1,5,B,Hung Hom,Departure,0,0,0,0
3/21/2020,Q1,5,B,Lo Wu,Arrival,0,0,0,0
3/21/2020,Q1,5,B,Lo Wu,Departure,0,0,0,0
3/21/2020,Q1,5,B,Lok Ma Chau Spur Line,Arrival,0,0,0,0
3/21/2020,Q1,5,B,Lok Ma Chau Spur Line,Departure,0,0,0,0
3/21/2020,Q1,5,B,Hong Kong-Zhuhai-Macao Bridge,Arrival,4805,37,388,5230
3/21/2020,Q1,5,B,Hong Kong-Zhuhai-Macao Bridge,Departure,5244,70,536,5850
3/21/2020,Q1,5,B,Lok Ma Chau,Arrival,0,0,0,0
3/21/2020,Q1,5,B,Lok Ma Chau,Departure,0,0,0,0
3/21/2020,Q1,5,B,Man Kam To,Arrival,0,0,0,0
3/21/2020,Q1,5,B,Man Kam To,Departure,0,0,0,0
3/21/2020,Q1,5,B,Sha Tau Kok,Arrival,0,0,0,0
3/21/2020,Q1,5,B,Sha Tau Kok,Departure,0,0,0,0
3/21/2020,Q1,5,B,Shenzhen Bay,Arrival,904,239,5,1148
3/21/2020,Q1,5,B,Shenzhen Bay,Departure,1384,457,113,1954
3/21/2020,Q1,5,B,China Ferry Terminal,Arrival,0,0,0,0
3/21/2020,Q1,5,B,China Ferry Terminal,Departure,0,0,0,0
3/21/2020,Q1,5,B,Harbour Control,Arrival,0,0,0,0
3/21/2020,Q1,5,B,Harbour Control,Departure,0,0,0,0
3/21/2020,Q1,5,B,Kai Tak Cruise Terminal,Arrival,0,0,0,0
3/21/2020,Q1,5,B,Kai Tak Cruise Terminal,Departure,0,0,0,0
3/21/2020,Q1,5,B,Macau Ferry Terminal,Arrival,0,0,0,0
3/21/2020,Q1,5,B,Macau Ferry Terminal,Departure,0,0,0,0
3/21/2020,Q1,5,B,Tuen Mun Ferry Terminal,Arrival,0,0,0,0
3/21/2020,Q1,5,B,Tuen Mun Ferry Terminal,Departure,0,0,0,0
3/22/2020,Q1,5,B,Airport,Arrival,5596,33,566,6195
3/22/2020,Q1,5,B,Airport,Departure,659,49,228,936
3/22/2020,Q1,5,B,Express Rail Link West Kowloon,Arrival,0,0,0,0
3/22/2020,Q1,5,B,Express Rail Link West Kowloon,Departure,0,0,0,0
3/22/2020,Q1,5,B,Hung Hom,Arrival,0,0,0,0
3/22/2020,Q1,5,B,Hung Hom,Departure,0,0,0,0
3/22/2020,Q1,5,B,Lo Wu,Arrival,0,0,0,0
3/22/2020,Q1,5,B,Lo Wu,Departure,0,0,0,0
3/22/2020,Q1,5,B,Lok Ma Chau Spur Line,Arrival,0,0,0,0
3/22/2020,Q1,5,B,Lok Ma Chau Spur Line,Departure,0,0,0,0
3/22/2020,Q1,5,B,Hong Kong-Zhuhai-Macao Bridge,Arrival,4996,31,235,5262
3/22/2020,Q1,5,B,Hong Kong-Zhuhai-Macao Bridge,Departure,4386,49,453,4888
3/22/2020,Q1,5,B,Lok Ma Chau,Arrival,0,0,0,0
3/22/2020,Q1,5,B,Lok Ma Chau,Departure,0,0,0,0
3/22/2020,Q1,5,B,Man Kam To,Arrival,0,0,0,0
3/22/2020,Q1,5,B,Man Kam To,Departure,0,0,0,0
3/22/2020,Q1,5,B,Sha Tau Kok,Arrival,0,0,0,0
3/22/2020,Q1,5,B,Sha Tau Kok,Departure,0,0,0,0
3/22/2020,Q1,5,B,Shenzhen Bay,Arrival,1064,272,4,1340
3/22/2020,Q1,5,B,Shenzhen Bay,Departure,1619,567,199,2385
3/22/2020,Q1,5,B,China Ferry Terminal,Arrival,0,0,0,0
3/22/2020,Q1,5,B,China Ferry Terminal,Departure,0,0,0,0
3/22/2020,Q1,5,B,Harbour Control,Arrival,0,0,0,0
3/22/2020,Q1,5,B,Harbour Control,Departure,0,0,0,0
3/22/2020,Q1,5,B,Kai Tak Cruise Terminal,Arrival,0,0,0,0
3/22/2020,Q1,5,B,Kai Tak Cruise Terminal,Departure,0,0,0,0
3/22/2020,Q1,5,B,Macau Ferry Terminal,Arrival,0,0,0,0
3/22/2020,Q1,5,B,Macau Ferry Terminal,Departure,0,0,0,0
3/22/2020,Q1,5,B,Tuen Mun Ferry Terminal,Arrival,0,0,0,0
3/22/2020,Q1,5,B,Tuen Mun Ferry Terminal,Departure,0,0,0,0
3/23/2020,Q1,5,B,Airport,Arrival,4536,30,529,5095
3/23/2020,Q1,5,B,Airport,Departure,514,34,208,756
3/23/2020,Q1,5,B,Express Rail Link West Kowloon,Arrival,0,0,0,0
3/23/2020,Q1,5,B,Express Rail Link West Kowloon,Departure,0,0,0,0
3/23/2020,Q1,5,B,Hung Hom,Arrival,0,0,0,0
3/23/2020,Q1,5,B,Hung Hom,Departure,0,0,0,0
3/23/2020,Q1,5,B,Lo Wu,Arrival,0,0,0,0
3/23/2020,Q1,5,B,Lo Wu,Departure,0,0,0,0
3/23/2020,Q1,5,B,Lok Ma Chau Spur Line,Arrival,0,0,0,0
3/23/2020,Q1,5,B,Lok Ma Chau Spur Line,Departure,0,0,0,0
3/23/2020,Q1,5,B,Hong Kong-Zhuhai-Macao Bridge,Arrival,4930,16,353,5299
3/23/2020,Q1,5,B,Hong Kong-Zhuhai-Macao Bridge,Departure,5722,43,539,6304
3/23/2020,Q1,5,B,Lok Ma Chau,Arrival,0,0,0,0
3/23/2020,Q1,5,B,Lok Ma Chau,Departure,0,0,0,0
3/23/2020,Q1,5,B,Man Kam To,Arrival,0,0,0,0
3/23/2020,Q1,5,B,Man Kam To,Departure,0,0,0,0
3/23/2020,Q1,5,B,Sha Tau Kok,Arrival,0,0,0,0
3/23/2020,Q1,5,B,Sha Tau Kok,Departure,0,0,0,0
3/23/2020,Q1,5,B,Shenzhen Bay,Arrival,1053,201,4,1258
3/23/2020,Q1,5,B,Shenzhen Bay,Departure,2229,462,207,2898
3/23/2020,Q1,5,B,China Ferry Terminal,Arrival,0,0,0,0
3/23/2020,Q1,5,B,China Ferry Terminal,Departure,0,0,0,0
3/23/2020,Q1,5,B,Harbour Control,Arrival,0,0,0,0
3/23/2020,Q1,5,B,Harbour Control,Departure,0,0,0,0
3/23/2020,Q1,5,B,Kai Tak Cruise Terminal,Arrival,0,0,0,0
3/23/2020,Q1,5,B,Kai Tak Cruise Terminal,Departure,0,0,0,0
3/23/2020,Q1,5,B,Macau Ferry Terminal,Arrival,0,0,0,0
3/23/2020,Q1,5,B,Macau Ferry Terminal,Departure,0,0,0,0
3/23/2020,Q1,5,B,Tuen Mun Ferry Terminal,Arrival,0,0,0,0
3/23/2020,Q1,5,B,Tuen Mun Ferry Terminal,Departure,0,0,0,0
3/24/2020,Q1,5,B,Airport,Arrival,3488,73,855,4416
3/24/2020,Q1,5,B,Airport,Departure,577,21,260,858
3/24/2020,Q1,5,B,Express Rail Link West Kowloon,Arrival,0,0,0,0
3/24/2020,Q1,5,B,Express Rail Link West Kowloon,Departure,0,0,0,0
3/24/2020,Q1,5,B,Hung Hom,Arrival,0,0,0,0
3/24/2020,Q1,5,B,Hung Hom,Departure,0,0,0,0
3/24/2020,Q1,5,B,Lo Wu,Arrival,0,0,0,0
3/24/2020,Q1,5,B,Lo Wu,Departure,0,0,0,0
3/24/2020,Q1,5,B,Lok Ma Chau Spur Line,Arrival,0,0,0,0
3/24/2020,Q1,5,B,Lok Ma Chau Spur Line,Departure,0,0,0,0
3/24/2020,Q1,5,B,Hong Kong-Zhuhai-Macao Bridge,Arrival,7851,47,942,8840
3/24/2020,Q1,5,B,Hong Kong-Zhuhai-Macao Bridge,Departure,6050,67,1082,7199
3/24/2020,Q1,5,B,Lok Ma Chau,Arrival,0,0,0,0
3/24/2020,Q1,5,B,Lok Ma Chau,Departure,0,0,0,0
3/24/2020,Q1,5,B,Man Kam To,Arrival,0,0,0,0
3/24/2020,Q1,5,B,Man Kam To,Departure,0,0,0,0
3/24/2020,Q1,5,B,Sha Tau Kok,Arrival,0,0,0,0
3/24/2020,Q1,5,B,Sha Tau Kok,Departure,0,0,0,0
3/24/2020,Q1,5,B,Shenzhen Bay,Arrival,1198,317,12,1527
3/24/2020,Q1,5,B,Shenzhen Bay,Departure,1793,453,401,2647
3/24/2020,Q1,5,B,China Ferry Terminal,Arrival,0,0,0,0
3/24/2020,Q1,5,B,China Ferry Terminal,Departure,0,0,0,0
3/24/2020,Q1,5,B,Harbour Control,Arrival,0,0,0,0
3/24/2020,Q1,5,B,Harbour Control,Departure,0,0,0,0
3/24/2020,Q1,5,B,Kai Tak Cruise Terminal,Arrival,0,0,0,0
3/24/2020,Q1,5,B,Kai Tak Cruise Terminal,Departure,0,0,0,0
3/24/2020,Q1,5,B,Macau Ferry Terminal,Arrival,0,0,0,0
3/24/2020,Q1,5,B,Macau Ferry Terminal,Departure,0,0,0,0
3/24/2020,Q1,5,B,Tuen Mun Ferry Terminal,Arrival,0,0,0,0
3/24/2020,Q1,5,B,Tuen Mun Ferry Terminal,Departure,0,0,0,0
3/25/2020,Q1,5,B,Airport,Arrival,4053,6,158,4217
3/25/2020,Q1,5,B,Airport,Departure,629,21,236,886
3/25/2020,Q1,5,B,Express Rail Link West Kowloon,Arrival,0,0,0,0
3/25/2020,Q1,5,B,Express Rail Link West Kowloon,Departure,0,0,0,0
3/25/2020,Q1,5,B,Hung Hom,Arrival,0,0,0,0
3/25/2020,Q1,5,B,Hung Hom,Departure,0,0,0,0
3/25/2020,Q1,5,B,Lo Wu,Arrival,0,0,0,0
3/25/2020,Q1,5,B,Lo Wu,Departure,0,0,0,0
3/25/2020,Q1,5,B,Lok Ma Chau Spur Line,Arrival,0,0,0,0
3/25/2020,Q1,5,B,Lok Ma Chau Spur Line,Departure,0,0,0,0
3/25/2020,Q1,5,B,Hong Kong-Zhuhai-Macao Bridge,Arrival,106,7,19,132
3/25/2020,Q1,5,B,Hong Kong-Zhuhai-Macao Bridge,Departure,212,25,173,410
3/25/2020,Q1,5,B,Lok Ma Chau,Arrival,0,0,0,0
3/25/2020,Q1,5,B,Lok Ma Chau,Departure,0,0,0,0
3/25/2020,Q1,5,B,Man Kam To,Arrival,0,0,0,0
3/25/2020,Q1,5,B,Man Kam To,Departure,0,0,0,0
3/25/2020,Q1,5,B,Sha Tau Kok,Arrival,0,0,0,0
3/25/2020,Q1,5,B,Sha Tau Kok,Departure,0,0,0,0
3/25/2020,Q1,5,B,Shenzhen Bay,Arrival,810,135,3,948
3/25/2020,Q1,5,B,Shenzhen Bay,Departure,1525,326,21,1872
3/25/2020,Q1,5,B,China Ferry Terminal,Arrival,0,0,0,0
3/25/2020,Q1,5,B,China Ferry Terminal,Departure,0,0,0,0
3/25/2020,Q1,5,B,Harbour Control,Arrival,0,0,0,0
3/25/2020,Q1,5,B,Harbour Control,Departure,0,0,0,0
3/25/2020,Q1,5,B,Kai Tak Cruise Terminal,Arrival,0,0,0,0
3/25/2020,Q1,5,B,Kai Tak Cruise Terminal,Departure,0,0,0,0
3/25/2020,Q1,5,B,Macau Ferry Terminal,Arrival,0,0,0,0
3/25/2020,Q1,5,B,Macau Ferry Terminal,Departure,0,0,0,0
3/25/2020,Q1,5,B,Tuen Mun Ferry Terminal,Arrival,0,0,0,0
3/25/2020,Q1,5,B,Tuen Mun Ferry Terminal,Departure,0,0,0,0
3/26/2020,Q1,5,B,Airport,Arrival,3303,6,126,3435
3/26/2020,Q1,5,B,Airport,Departure,436,20,138,594
3/26/2020,Q1,5,B,Express Rail Link West Kowloon,Arrival,0,0,0,0
3/26/2020,Q1,5,B,Express Rail Link West Kowloon,Departure,0,0,0,0
3/26/2020,Q1,5,B,Hung Hom,Arrival,0,0,0,0
3/26/2020,Q1,5,B,Hung Hom,Departure,0,0,0,0
3/26/2020,Q1,5,B,Lo Wu,Arrival,0,0,0,0
3/26/2020,Q1,5,B,Lo Wu,Departure,0,0,0,0
3/26/2020,Q1,5,B,Lok Ma Chau Spur Line,Arrival,0,0,0,0
3/26/2020,Q1,5,B,Lok Ma Chau Spur Line,Departure,0,0,0,0
3/26/2020,Q1,5,B,Hong Kong-Zhuhai-Macao Bridge,Arrival,95,8,23,126
3/26/2020,Q1,5,B,Hong Kong-Zhuhai-Macao Bridge,Departure,342,42,113,497
3/26/2020,Q1,5,B,Lok Ma Chau,Arrival,0,0,0,0
3/26/2020,Q1,5,B,Lok Ma Chau,Departure,0,0,0,0
3/26/2020,Q1,5,B,Man Kam To,Arrival,0,0,0,0
3/26/2020,Q1,5,B,Man Kam To,Departure,0,0,0,0
3/26/2020,Q1,5,B,Sha Tau Kok,Arrival,0,0,0,0
3/26/2020,Q1,5,B,Sha Tau Kok,Departure,0,0,0,0
3/26/2020,Q1,5,B,Shenzhen Bay,Arrival,773,122,2,897
3/26/2020,Q1,5,B,Shenzhen Bay,Departure,2476,522,16,3014
3/26/2020,Q1,5,B,China Ferry Terminal,Arrival,0,0,0,0
3/26/2020,Q1,5,B,China Ferry Terminal,Departure,0,0,0,0
3/26/2020,Q1,5,B,Harbour Control,Arrival,0,0,0,0
3/26/2020,Q1,5,B,Harbour Control,Departure,0,0,0,0
3/26/2020,Q1,5,B,Kai Tak Cruise Terminal,Arrival,0,0,0,0
3/26/2020,Q1,5,B,Kai Tak Cruise Terminal,Departure,0,0,0,0
3/26/2020,Q1,5,B,Macau Ferry Terminal,Arrival,0,0,0,0
3/26/2020,Q1,5,B,Macau Ferry Terminal,Departure,0,0,0,0
3/26/2020,Q1,5,B,Tuen Mun Ferry Terminal,Arrival,0,0,0,0
3/26/2020,Q1,5,B,Tuen Mun Ferry Terminal,Departure,0,0,0,0
3/27/2020,Q1,5,B,Airport,Arrival,2903,4,178,3085
3/27/2020,Q1,5,B,Airport,Departure,1030,46,238,1314
3/27/2020,Q1,5,B,Express Rail Link West Kowloon,Arrival,0,0,0,0
3/27/2020,Q1,5,B,Express Rail Link West Kowloon,Departure,0,0,0,0
3/27/2020,Q1,5,B,Hung Hom,Arrival,0,0,0,0
3/27/2020,Q1,5,B,Hung Hom,Departure,0,0,0,0
3/27/2020,Q1,5,B,Lo Wu,Arrival,0,0,0,0
3/27/2020,Q1,5,B,Lo Wu,Departure,0,0,0,0
3/27/2020,Q1,5,B,Lok Ma Chau Spur Line,Arrival,0,0,0,0
3/27/2020,Q1,5,B,Lok Ma Chau Spur Line,Departure,0,0,0,0
3/27/2020,Q1,5,B,Hong Kong-Zhuhai-Macao Bridge,Arrival,124,9,17,150
3/27/2020,Q1,5,B,Hong Kong-Zhuhai-Macao Bridge,Departure,697,120,170,987
3/27/2020,Q1,5,B,Lok Ma Chau,Arrival,0,0,0,0
3/27/2020,Q1,5,B,Lok Ma Chau,Departure,0,0,0,0
3/27/2020,Q1,5,B,Man Kam To,Arrival,0,0,0,0
3/27/2020,Q1,5,B,Man Kam To,Departure,0,0,0,0
3/27/2020,Q1,5,B,Sha Tau Kok,Arrival,0,0,0,0
3/27/2020,Q1,5,B,Sha Tau Kok,Departure,0,0,0,0
3/27/2020,Q1,5,B,Shenzhen Bay,Arrival,676,121,1,798
3/27/2020,Q1,5,B,Shenzhen Bay,Departure,298,83,113,494
3/27/2020,Q1,5,B,China Ferry Terminal,Arrival,0,0,0,0
3/27/2020,Q1,5,B,China Ferry Terminal,Departure,0,0,0,0
3/27/2020,Q1,5,B,Harbour Control,Arrival,0,0,0,0
3/27/2020,Q1,5,B,Harbour Control,Departure,0,0,0,0
3/27/2020,Q1,5,B,Kai Tak Cruise Terminal,Arrival,0,0,0,0
3/27/2020,Q1,5,B,Kai Tak Cruise Terminal,Departure,0,0,0,0
3/27/2020,Q1,5,B,Macau Ferry Terminal,Arrival,0,0,0,0
3/27/2020,Q1,5,B,Macau Ferry Terminal,Departure,0,0,0,0
3/27/2020,Q1,5,B,Tuen Mun Ferry Terminal,Arrival,0,0,0,0
3/27/2020,Q1,5,B,Tuen Mun Ferry Terminal,Departure,0,0,0,0
3/28/2020,Q1,5,B,Airport,Arrival,3744,7,175,3926
3/28/2020,Q1,5,B,Airport,Departure,691,51,162,904
3/28/2020,Q1,5,B,Express Rail Link West Kowloon,Arrival,0,0,0,0
3/28/2020,Q1,5,B,Express Rail Link West Kowloon,Departure,0,0,0,0
3/28/2020,Q1,5,B,Hung Hom,Arrival,0,0,0,0
3/28/2020,Q1,5,B,Hung Hom,Departure,0,0,0,0
3/28/2020,Q1,5,B,Lo Wu,Arrival,0,0,0,0
3/28/2020,Q1,5,B,Lo Wu,Departure,0,0,0,0
3/28/2020,Q1,5,B,Lok Ma Chau Spur Line,Arrival,0,0,0,0
3/28/2020,Q1,5,B,Lok Ma Chau Spur Line,Departure,0,0,0,0
3/28/2020,Q1,5,B,Hong Kong-Zhuhai-Macao Bridge,Arrival,67,7,16,90
3/28/2020,Q1,5,B,Hong Kong-Zhuhai-Macao Bridge,Departure,45,3,146,194
3/28/2020,Q1,5,B,Lok Ma Chau,Arrival,0,0,0,0
3/28/2020,Q1,5,B,Lok Ma Chau,Departure,0,0,0,0
3/28/2020,Q1,5,B,Man Kam To,Arrival,0,0,0,0
3/28/2020,Q1,5,B,Man Kam To,Departure,0,0,0,0
3/28/2020,Q1,5,B,Sha Tau Kok,Arrival,0,0,0,0
3/28/2020,Q1,5,B,Sha Tau Kok,Departure,0,0,0,0
3/28/2020,Q1,5,B,Shenzhen Bay,Arrival,545,96,5,646
3/28/2020,Q1,5,B,Shenzhen Bay,Departure,238,102,3,343
3/28/2020,Q1,5,B,China Ferry Terminal,Arrival,0,0,0,0
3/28/2020,Q1,5,B,China Ferry Terminal,Departure,0,0,0,0
3/28/2020,Q1,5,B,Harbour Control,Arrival,0,0,0,0
3/28/2020,Q1,5,B,Harbour Control,Departure,0,0,0,0
3/28/2020,Q1,5,B,Kai Tak Cruise Terminal,Arrival,0,0,0,0
3/28/2020,Q1,5,B,Kai Tak Cruise Terminal,Departure,0,0,0,0
3/28/2020,Q1,5,B,Macau Ferry Terminal,Arrival,0,0,0,0
3/28/2020,Q1,5,B,Macau Ferry Terminal,Departure,0,0,0,0
3/28/2020,Q1,5,B,Tuen Mun Ferry Terminal,Arrival,0,0,0,0
3/28/2020,Q1,5,B,Tuen Mun Ferry Terminal,Departure,0,0,0,0
3/29/2020,Q1,5,B,Airport,Arrival,2616,6,215,2837
3/29/2020,Q1,5,B,Airport,Departure,301,25,77,403
3/29/2020,Q1,5,B,Express Rail Link West Kowloon,Arrival,0,0,0,0
3/29/2020,Q1,5,B,Express Rail Link West Kowloon,Departure,0,0,0,0
3/29/2020,Q1,5,B,Hung Hom,Arrival,0,0,0,0
3/29/2020,Q1,5,B,Hung Hom,Departure,0,0,0,0
3/29/2020,Q1,5,B,Lo Wu,Arrival,0,0,0,0
3/29/2020,Q1,5,B,Lo Wu,Departure,0,0,0,0
3/29/2020,Q1,5,B,Lok Ma Chau Spur Line,Arrival,0,0,0,0
3/29/2020,Q1,5,B,Lok Ma Chau Spur Line,Departure,0,0,0,0
3/29/2020,Q1,5,B,Hong Kong-Zhuhai-Macao Bridge,Arrival,60,7,16,83
3/29/2020,Q1,5,B,Hong Kong-Zhuhai-Macao Bridge,Departure,36,5,181,222
3/29/2020,Q1,5,B,Lok Ma Chau,Arrival,0,0,0,0
3/29/2020,Q1,5,B,Lok Ma Chau,Departure,0,0,0,0
3/29/2020,Q1,5,B,Man Kam To,Arrival,0,0,0,0
3/29/2020,Q1,5,B,Man Kam To,Departure,0,0,0,0
3/29/2020,Q1,5,B,Sha Tau Kok,Arrival,0,0,0,0
3/29/2020,Q1,5,B,Sha Tau Kok,Departure,0,0,0,0
3/29/2020,Q1,5,B,Shenzhen Bay,Arrival,554,110,0,664
3/29/2020,Q1,5,B,Shenzhen Bay,Departure,221,67,2,290
3/29/2020,Q1,5,B,China Ferry Terminal,Arrival,0,0,0,0
3/29/2020,Q1,5,B,China Ferry Terminal,Departure,0,0,0,0
3/29/2020,Q1,5,B,Harbour Control,Arrival,0,0,0,0
3/29/2020,Q1,5,B,Harbour Control,Departure,0,0,0,0
3/29/2020,Q1,5,B,Kai Tak Cruise Terminal,Arrival,0,0,0,0
3/29/2020,Q1,5,B,Kai Tak Cruise Terminal,Departure,0,0,0,0
3/29/2020,Q1,5,B,Macau Ferry Terminal,Arrival,0,0,0,0
3/29/2020,Q1,5,B,Macau Ferry Terminal,Departure,0,0,0,0
3/29/2020,Q1,5,B,Tuen Mun Ferry Terminal,Arrival,0,0,0,0
3/29/2020,Q1,5,B,Tuen Mun Ferry Terminal,Departure,0,0,0,0
3/30/2020,Q1,5,B,Airport,Arrival,1924,7,138,2069
3/30/2020,Q1,5,B,Airport,Departure,346,10,92,448
3/30/2020,Q1,5,B,Express Rail Link West Kowloon,Arrival,0,0,0,0
3/30/2020,Q1,5,B,Express Rail Link West Kowloon,Departure,0,0,0,0
3/30/2020,Q1,5,B,Hung Hom,Arrival,0,0,0,0
3/30/2020,Q1,5,B,Hung Hom,Departure,0,0,0,0
3/30/2020,Q1,5,B,Lo Wu,Arrival,0,0,0,0
3/30/2020,Q1,5,B,Lo Wu,Departure,0,0,0,0
3/30/2020,Q1,5,B,Lok Ma Chau Spur Line,Arrival,0,0,0,0
3/30/2020,Q1,5,B,Lok Ma Chau Spur Line,Departure,0,0,0,0
3/30/2020,Q1,5,B,Hong Kong-Zhuhai-Macao Bridge,Arrival,60,4,16,80
3/30/2020,Q1,5,B,Hong Kong-Zhuhai-Macao Bridge,Departure,50,4,145,199
3/30/2020,Q1,5,B,Lok Ma Chau,Arrival,0,0,0,0
3/30/2020,Q1,5,B,Lok Ma Chau,Departure,0,0,0,0
3/30/2020,Q1,5,B,Man Kam To,Arrival,0,0,0,0
3/30/2020,Q1,5,B,Man Kam To,Departure,0,0,0,0
3/30/2020,Q1,5,B,Sha Tau Kok,Arrival,0,0,0,0
3/30/2020,Q1,5,B,Sha Tau Kok,Departure,0,0,0,0
3/30/2020,Q1,5,B,Shenzhen Bay,Arrival,704,79,1,784
3/30/2020,Q1,5,B,Shenzhen Bay,Departure,284,82,4,370
3/30/2020,Q1,5,B,China Ferry Terminal,Arrival,0,0,0,0
3/30/2020,Q1,5,B,China Ferry Terminal,Departure,0,0,0,0
3/30/2020,Q1,5,B,Harbour Control,Arrival,0,0,0,0
3/30/2020,Q1,5,B,Harbour Control,Departure,0,0,0,0
3/30/2020,Q1,5,B,Kai Tak Cruise Terminal,Arrival,0,0,0,0
3/30/2020,Q1,5,B,Kai Tak Cruise Terminal,Departure,0,0,0,0
3/30/2020,Q1,5,B,Macau Ferry Terminal,Arrival,0,0,0,0
3/30/2020,Q1,5,B,Macau Ferry Terminal,Departure,0,0,0,0
3/30/2020,Q1,5,B,Tuen Mun Ferry Terminal,Arrival,0,0,0,0
3/30/2020,Q1,5,B,Tuen Mun Ferry Terminal,Departure,0,0,0,0
3/31/2020,Q1,5,B,Airport,Arrival,1406,9,119,1534
3/31/2020,Q1,5,B,Airport,Departure,569,20,142,731
3/31/2020,Q1,5,B,Express Rail Link West Kowloon,Arrival,0,0,0,0
3/31/2020,Q1,5,B,Express Rail Link West Kowloon,Departure,0,0,0,0
3/31/2020,Q1,5,B,Hung Hom,Arrival,0,0,0,0
3/31/2020,Q1,5,B,Hung Hom,Departure,0,0,0,0
3/31/2020,Q1,5,B,Lo Wu,Arrival,0,0,0,0
3/31/2020,Q1,5,B,Lo Wu,Departure,0,0,0,0
3/31/2020,Q1,5,B,Lok Ma Chau Spur Line,Arrival,0,0,0,0
3/31/2020,Q1,5,B,Lok Ma Chau Spur Line,Departure,0,0,0,0
3/31/2020,Q1,5,B,Hong Kong-Zhuhai-Macao Bridge,Arrival,76,5,17,98
3/31/2020,Q1,5,B,Hong Kong-Zhuhai-Macao Bridge,Departure,56,6,122,184
3/31/2020,Q1,5,B,Lok Ma Chau,Arrival,0,0,0,0
3/31/2020,Q1,5,B,Lok Ma Chau,Departure,0,0,0,0
3/31/2020,Q1,5,B,Man Kam To,Arrival,0,0,0,0
3/31/2020,Q1,5,B,Man Kam To,Departure,0,0,0,0
3/31/2020,Q1,5,B,Sha Tau Kok,Arrival,0,0,0,0
3/31/2020,Q1,5,B,Sha Tau Kok,Departure,0,0,0,0
3/31/2020,Q1,5,B,Shenzhen Bay,Arrival,763,97,3,863
3/31/2020,Q1,5,B,Shenzhen Bay,Departure,366,67,3,436
3/31/2020,Q1,5,B,China Ferry Terminal,Arrival,0,0,0,0
3/31/2020,Q1,5,B,China Ferry Terminal,Departure,0,0,0,0
3/31/2020,Q1,5,B,Harbour Control,Arrival,0,0,0,0
3/31/2020,Q1,5,B,Harbour Control,Departure,0,0,0,0
3/31/2020,Q1,5,B,Kai Tak Cruise Terminal,Arrival,0,0,0,0
3/31/2020,Q1,5,B,Kai Tak Cruise Terminal,Departure,0,0,0,0
3/31/2020,Q1,5,B,Macau Ferry Terminal,Arrival,0,0,0,0
3/31/2020,Q1,5,B,Macau Ferry Terminal,Departure,0,0,0,0
3/31/2020,Q1,5,B,Tuen Mun Ferry Terminal,Arrival,0,0,0,0
3/31/2020,Q1,5,B,Tuen Mun Ferry Terminal,Departure,0,0,0,0
4/1/2020,Q2,5,B,Airport,Arrival,1144,5,34,1183
4/1/2020,Q2,5,B,Airport,Departure,526,36,86,648
4/1/2020,Q2,5,B,Express Rail Link West Kowloon,Arrival,0,0,0,0
4/1/2020,Q2,5,B,Express Rail Link West Kowloon,Departure,0,0,0,0
4/1/2020,Q2,5,B,Hung Hom,Arrival,0,0,0,0
4/1/2020,Q2,5,B,Hung Hom,Departure,0,0,0,0
4/1/2020,Q2,5,B,Lo Wu,Arrival,0,0,0,0
4/1/2020,Q2,5,B,Lo Wu,Departure,0,0,0,0
4/1/2020,Q2,5,B,Lok Ma Chau Spur Line,Arrival,0,0,0,0
4/1/2020,Q2,5,B,Lok Ma Chau Spur Line,Departure,0,0,0,0
4/1/2020,Q2,5,B,Hong Kong-Zhuhai-Macao Bridge,Arrival,68,7,4,79
4/1/2020,Q2,5,B,Hong Kong-Zhuhai-Macao Bridge,Departure,42,4,16,62
4/1/2020,Q2,5,B,Lok Ma Chau,Arrival,0,0,0,0
4/1/2020,Q2,5,B,Lok Ma Chau,Departure,0,0,0,0
4/1/2020,Q2,5,B,Man Kam To,Arrival,0,0,0,0
4/1/2020,Q2,5,B,Man Kam To,Departure,0,0,0,0
4/1/2020,Q2,5,B,Sha Tau Kok,Arrival,0,0,0,0
4/1/2020,Q2,5,B,Sha Tau Kok,Departure,0,0,0,0
4/1/2020,Q2,5,B,Shenzhen Bay,Arrival,798,84,2,884
4/1/2020,Q2,5,B,Shenzhen Bay,Departure,385,123,0,508
4/1/2020,Q2,5,B,China Ferry Terminal,Arrival,0,0,0,0
4/1/2020,Q2,5,B,China Ferry Terminal,Departure,0,0,0,0
4/1/2020,Q2,5,B,Harbour Control,Arrival,0,0,0,0
4/1/2020,Q2,5,B,Harbour Control,Departure,0,0,0,0
4/1/2020,Q2,5,B,Kai Tak Cruise Terminal,Arrival,0,0,0,0
4/1/2020,Q2,5,B,Kai Tak Cruise Terminal,Departure,0,0,0,0
4/1/2020,Q2,5,B,Macau Ferry Terminal,Arrival,0,0,0,0
4/1/2020,Q2,5,B,Macau Ferry Terminal,Departure,0,0,0,0
4/1/2020,Q2,5,B,Tuen Mun Ferry Terminal,Arrival,0,0,0,0
4/1/2020,Q2,5,B,Tuen Mun Ferry Terminal,Departure,0,0,0,0
4/2/2020,Q2,5,B,Airport,Arrival,662,4,9,675
4/2/2020,Q2,5,B,Airport,Departure,269,21,59,349
4/2/2020,Q2,5,B,Express Rail Link West Kowloon,Arrival,0,0,0,0
4/2/2020,Q2,5,B,Express Rail Link West Kowloon,Departure,0,0,0,0
4/2/2020,Q2,5,B,Hung Hom,Arrival,0,0,0,0
4/2/2020,Q2,5,B,Hung Hom,Departure,0,0,0,0
4/2/2020,Q2,5,B,Lo Wu,Arrival,0,0,0,0
4/2/2020,Q2,5,B,Lo Wu,Departure,0,0,0,0
4/2/2020,Q2,5,B,Lok Ma Chau Spur Line,Arrival,0,0,0,0
4/2/2020,Q2,5,B,Lok Ma Chau Spur Line,Departure,0,0,0,0
4/2/2020,Q2,5,B,Hong Kong-Zhuhai-Macao Bridge,Arrival,67,3,0,70
4/2/2020,Q2,5,B,Hong Kong-Zhuhai-Macao Bridge,Departure,70,0,6,76
4/2/2020,Q2,5,B,Lok Ma Chau,Arrival,0,0,0,0
4/2/2020,Q2,5,B,Lok Ma Chau,Departure,0,0,0,0
4/2/2020,Q2,5,B,Man Kam To,Arrival,0,0,0,0
4/2/2020,Q2,5,B,Man Kam To,Departure,0,0,0,0
4/2/2020,Q2,5,B,Sha Tau Kok,Arrival,0,0,0,0
4/2/2020,Q2,5,B,Sha Tau Kok,Departure,0,0,0,0
4/2/2020,Q2,5,B,Shenzhen Bay,Arrival,631,69,0,700
4/2/2020,Q2,5,B,Shenzhen Bay,Departure,371,87,7,465
4/2/2020,Q2,5,B,China Ferry Terminal,Arrival,0,0,0,0
4/2/2020,Q2,5,B,China Ferry Terminal,Departure,0,0,0,0
4/2/2020,Q2,5,B,Harbour Control,Arrival,0,0,0,0
4/2/2020,Q2,5,B,Harbour Control,Departure,0,0,0,0
4/2/2020,Q2,5,B,Kai Tak Cruise Terminal,Arrival,0,0,0,0
4/2/2020,Q2,5,B,Kai Tak Cruise Terminal,Departure,0,0,0,0
4/2/2020,Q2,5,B,Macau Ferry Terminal,Arrival,0,0,0,0
4/2/2020,Q2,5,B,Macau Ferry Terminal,Departure,0,0,0,0
4/2/2020,Q2,5,B,Tuen Mun Ferry Terminal,Arrival,0,0,0,0
4/2/2020,Q2,5,B,Tuen Mun Ferry Terminal,Departure,0,0,0,0
4/3/2020,Q2,5,B,Airport,Arrival,979,6,24,1009
4/3/2020,Q2,5,B,Airport,Departure,610,38,87,735
4/3/2020,Q2,5,B,Express Rail Link West Kowloon,Arrival,0,0,0,0
4/3/2020,Q2,5,B,Express Rail Link West Kowloon,Departure,0,0,0,0
4/3/2020,Q2,5,B,Hung Hom,Arrival,0,0,0,0
4/3/2020,Q2,5,B,Hung Hom,Departure,0,0,0,0
4/3/2020,Q2,5,B,Lo Wu,Arrival,0,0,0,0
4/3/2020,Q2,5,B,Lo Wu,Departure,0,0,0,0
4/3/2020,Q2,5,B,Lok Ma Chau Spur Line,Arrival,0,0,0,0
4/3/2020,Q2,5,B,Lok Ma Chau Spur Line,Departure,0,0,0,0
4/3/2020,Q2,5,B,Hong Kong-Zhuhai-Macao Bridge,Arrival,59,6,4,69
4/3/2020,Q2,5,B,Hong Kong-Zhuhai-Macao Bridge,Departure,59,7,6,72
4/3/2020,Q2,5,B,Lok Ma Chau,Arrival,0,0,0,0
4/3/2020,Q2,5,B,Lok Ma Chau,Departure,0,0,0,0
4/3/2020,Q2,5,B,Man Kam To,Arrival,0,0,0,0
4/3/2020,Q2,5,B,Man Kam To,Departure,0,0,0,0
4/3/2020,Q2,5,B,Sha Tau Kok,Arrival,0,0,0,0
4/3/2020,Q2,5,B,Sha Tau Kok,Departure,0,0,0,0
4/3/2020,Q2,5,B,Shenzhen Bay,Arrival,489,85,0,574
4/3/2020,Q2,5,B,Shenzhen Bay,Departure,353,96,7,456
4/3/2020,Q2,5,B,China Ferry Terminal,Arrival,0,0,0,0
4/3/2020,Q2,5,B,China Ferry Terminal,Departure,0,0,0,0
4/3/2020,Q2,5,B,Harbour Control,Arrival,0,0,0,0
4/3/2020,Q2,5,B,Harbour Control,Departure,0,0,0,0
4/3/2020,Q2,5,B,Kai Tak Cruise Terminal,Arrival,0,0,0,0
4/3/2020,Q2,5,B,Kai Tak Cruise Terminal,Departure,0,0,0,0
4/3/2020,Q2,5,B,Macau Ferry Terminal,Arrival,0,0,0,0
4/3/2020,Q2,5,B,Macau Ferry Terminal,Departure,0,0,0,0
4/3/2020,Q2,5,B,Tuen Mun Ferry Terminal,Arrival,0,0,0,0
4/3/2020,Q2,5,B,Tuen Mun Ferry Terminal,Departure,0,0,0,0
4/4/2020,Q2,5,D,Airport,Arrival,812,3,15,830
4/4/2020,Q2,5,D,Airport,Departure,403,20,51,474
4/4/2020,Q2,5,D,Express Rail Link West Kowloon,Arrival,0,0,0,0
4/4/2020,Q2,5,D,Express Rail Link West Kowloon,Departure,0,0,0,0
4/4/2020,Q2,5,D,Hung Hom,Arrival,0,0,0,0
4/4/2020,Q2,5,D,Hung Hom,Departure,0,0,0,0
4/4/2020,Q2,5,D,Lo Wu,Arrival,0,0,0,0
4/4/2020,Q2,5,D,Lo Wu,Departure,0,0,0,0
4/4/2020,Q2,5,D,Lok Ma Chau Spur Line,Arrival,0,0,0,0
4/4/2020,Q2,5,D,Lok Ma Chau Spur Line,Departure,0,0,0,0
4/4/2020,Q2,5,D,Hong Kong-Zhuhai-Macao Bridge,Arrival,50,2,3,55
4/4/2020,Q2,5,D,Hong Kong-Zhuhai-Macao Bridge,Departure,58,6,3,67
4/4/2020,Q2,5,D,Lok Ma Chau,Arrival,0,0,0,0
4/4/2020,Q2,5,D,Lok Ma Chau,Departure,0,0,0,0
4/4/2020,Q2,5,D,Man Kam To,Arrival,0,0,0,0
4/4/2020,Q2,5,D,Man Kam To,Departure,0,0,0,0
4/4/2020,Q2,5,D,Sha Tau Kok,Arrival,0,0,0,0
4/4/2020,Q2,5,D,Sha Tau Kok,Departure,0,0,0,0
4/4/2020,Q2,5,D,Shenzhen Bay,Arrival,344,73,0,417
4/4/2020,Q2,5,D,Shenzhen Bay,Departure,296,86,5,387
4/4/2020,Q2,5,D,China Ferry Terminal,Arrival,0,0,0,0
4/4/2020,Q2,5,D,China Ferry Terminal,Departure,0,0,0,0
4/4/2020,Q2,5,D,Harbour Control,Arrival,0,0,0,0
4/4/2020,Q2,5,D,Harbour Control,Departure,0,0,0,0
4/4/2020,Q2,5,D,Kai Tak Cruise Terminal,Arrival,0,0,0,0
4/4/2020,Q2,5,D,Kai Tak Cruise Terminal,Departure,0,0,0,0
4/4/2020,Q2,5,D,Macau Ferry Terminal,Arrival,0,0,0,0
4/4/2020,Q2,5,D,Macau Ferry Terminal,Departure,0,0,0,0
4/4/2020,Q2,5,D,Tuen Mun Ferry Terminal,Arrival,0,0,0,0
4/4/2020,Q2,5,D,Tuen Mun Ferry Terminal,Departure,0,0,0,0
4/5/2020,Q2,5,D,Airport,Arrival,806,0,7,813
4/5/2020,Q2,5,D,Airport,Departure,284,10,71,365
4/5/2020,Q2,5,D,Express Rail Link West Kowloon,Arrival,0,0,0,0
4/5/2020,Q2,5,D,Express Rail Link West Kowloon,Departure,0,0,0,0
4/5/2020,Q2,5,D,Hung Hom,Arrival,0,0,0,0
4/5/2020,Q2,5,D,Hung Hom,Departure,0,0,0,0
4/5/2020,Q2,5,D,Lo Wu,Arrival,0,0,0,0
4/5/2020,Q2,5,D,Lo Wu,Departure,0,0,0,0
4/5/2020,Q2,5,D,Lok Ma Chau Spur Line,Arrival,0,0,0,0
4/5/2020,Q2,5,D,Lok Ma Chau Spur Line,Departure,0,0,0,0
4/5/2020,Q2,5,D,Hong Kong-Zhuhai-Macao Bridge,Arrival,226,12,18,256
4/5/2020,Q2,5,D,Hong Kong-Zhuhai-Macao Bridge,Departure,142,5,18,165
4/5/2020,Q2,5,D,Lok Ma Chau,Arrival,0,0,0,0
4/5/2020,Q2,5,D,Lok Ma Chau,Departure,0,0,0,0
4/5/2020,Q2,5,D,Man Kam To,Arrival,0,0,0,0
4/5/2020,Q2,5,D,Man Kam To,Departure,0,0,0,0
4/5/2020,Q2,5,D,Sha Tau Kok,Arrival,0,0,0,0
4/5/2020,Q2,5,D,Sha Tau Kok,Departure,0,0,0,0
4/5/2020,Q2,5,D,Shenzhen Bay,Arrival,479,100,1,580
4/5/2020,Q2,5,D,Shenzhen Bay,Departure,267,80,1,348
4/5/2020,Q2,5,D,China Ferry Terminal,Arrival,0,0,0,0
4/5/2020,Q2,5,D,China Ferry Terminal,Departure,0,0,0,0
4/5/2020,Q2,5,D,Harbour Control,Arrival,0,0,0,0
4/5/2020,Q2,5,D,Harbour Control,Departure,0,0,0,0
4/5/2020,Q2,5,D,Kai Tak Cruise Terminal,Arrival,0,0,0,0
4/5/2020,Q2,5,D,Kai Tak Cruise Terminal,Departure,0,0,0,0
4/5/2020,Q2,5,D,Macau Ferry Terminal,Arrival,0,0,0,0
4/5/2020,Q2,5,D,Macau Ferry Terminal,Departure,0,0,0,0
4/5/2020,Q2,5,D,Tuen Mun Ferry Terminal,Arrival,0,0,0,0
4/5/2020,Q2,5,D,Tuen Mun Ferry Terminal,Departure,0,0,0,0
4/6/2020,Q2,5,D,Airport,Arrival,833,2,13,848
4/6/2020,Q2,5,D,Airport,Departure,185,13,43,241
4/6/2020,Q2,5,D,Express Rail Link West Kowloon,Arrival,0,0,0,0
4/6/2020,Q2,5,D,Express Rail Link West Kowloon,Departure,0,0,0,0
4/6/2020,Q2,5,D,Hung Hom,Arrival,0,0,0,0
4/6/2020,Q2,5,D,Hung Hom,Departure,0,0,0,0
4/6/2020,Q2,5,D,Lo Wu,Arrival,0,0,0,0
4/6/2020,Q2,5,D,Lo Wu,Departure,0,0,0,0
4/6/2020,Q2,5,D,Lok Ma Chau Spur Line,Arrival,0,0,0,0
4/6/2020,Q2,5,D,Lok Ma Chau Spur Line,Departure,0,0,0,0
4/6/2020,Q2,5,D,Hong Kong-Zhuhai-Macao Bridge,Arrival,20,7,1,28
4/6/2020,Q2,5,D,Hong Kong-Zhuhai-Macao Bridge,Departure,27,2,0,29
4/6/2020,Q2,5,D,Lok Ma Chau,Arrival,0,0,0,0
4/6/2020,Q2,5,D,Lok Ma Chau,Departure,0,0,0,0
4/6/2020,Q2,5,D,Man Kam To,Arrival,0,0,0,0
4/6/2020,Q2,5,D,Man Kam To,Departure,0,0,0,0
4/6/2020,Q2,5,D,Sha Tau Kok,Arrival,0,0,0,0
4/6/2020,Q2,5,D,Sha Tau Kok,Departure,0,0,0,0
4/6/2020,Q2,5,D,Shenzhen Bay,Arrival,498,89,2,589
4/6/2020,Q2,5,D,Shenzhen Bay,Departure,446,72,6,524
4/6/2020,Q2,5,D,China Ferry Terminal,Arrival,0,0,0,0
4/6/2020,Q2,5,D,China Ferry Terminal,Departure,0,0,0,0
4/6/2020,Q2,5,D,Harbour Control,Arrival,0,0,0,0
4/6/2020,Q2,5,D,Harbour Control,Departure,0,0,0,0
4/6/2020,Q2,5,D,Kai Tak Cruise Terminal,Arrival,0,0,0,0
4/6/2020,Q2,5,D,Kai Tak Cruise Terminal,Departure,0,0,0,0
4/6/2020,Q2,5,D,Macau Ferry Terminal,Arrival,0,0,0,0
4/6/2020,Q2,5,D,Macau Ferry Terminal,Departure,0,0,0,0
4/6/2020,Q2,5,D,Tuen Mun Ferry Terminal,Arrival,0,0,0,0
4/6/2020,Q2,5,D,Tuen Mun Ferry Terminal,Departure,0,0,0,0
4/7/2020,Q2,5,D,Airport,Arrival,347,4,16,367
4/7/2020,Q2,5,D,Airport,Departure,217,14,43,274
4/7/2020,Q2,5,D,Express Rail Link West Kowloon,Arrival,0,0,0,0
4/7/2020,Q2,5,D,Express Rail Link West Kowloon,Departure,0,0,0,0
4/7/2020,Q2,5,D,Hung Hom,Arrival,0,0,0,0
4/7/2020,Q2,5,D,Hung Hom,Departure,0,0,0,0
4/7/2020,Q2,5,D,Lo Wu,Arrival,0,0,0,0
4/7/2020,Q2,5,D,Lo Wu,Departure,0,0,0,0
4/7/2020,Q2,5,D,Lok Ma Chau Spur Line,Arrival,0,0,0,0
4/7/2020,Q2,5,D,Lok Ma Chau Spur Line,Departure,0,0,0,0
4/7/2020,Q2,5,D,Hong Kong-Zhuhai-Macao Bridge,Arrival,34,8,0,42
4/7/2020,Q2,5,D,Hong Kong-Zhuhai-Macao Bridge,Departure,30,5,0,35
4/7/2020,Q2,5,D,Lok Ma Chau,Arrival,0,0,0,0
4/7/2020,Q2,5,D,Lok Ma Chau,Departure,0,0,0,0
4/7/2020,Q2,5,D,Man Kam To,Arrival,0,0,0,0
4/7/2020,Q2,5,D,Man Kam To,Departure,0,0,0,0
4/7/2020,Q2,5,D,Sha Tau Kok,Arrival,0,0,0,0
4/7/2020,Q2,5,D,Sha Tau Kok,Departure,0,0,0,0
4/7/2020,Q2,5,D,Shenzhen Bay,Arrival,511,72,0,583
4/7/2020,Q2,5,D,Shenzhen Bay,Departure,355,107,7,469
4/7/2020,Q2,5,D,China Ferry Terminal,Arrival,0,0,0,0
4/7/2020,Q2,5,D,China Ferry Terminal,Departure,0,0,0,0
4/7/2020,Q2,5,D,Harbour Control,Arrival,0,0,0,0
4/7/2020,Q2,5,D,Harbour Control,Departure,0,0,0,0
4/7/2020,Q2,5,D,Kai Tak Cruise Terminal,Arrival,0,0,0,0
4/7/2020,Q2,5,D,Kai Tak Cruise Terminal,Departure,0,0,0,0
4/7/2020,Q2,5,D,Macau Ferry Terminal,Arrival,0,0,0,0
4/7/2020,Q2,5,D,Macau Ferry Terminal,Departure,0,0,0,0
4/7/2020,Q2,5,D,Tuen Mun Ferry Terminal,Arrival,0,0,0,0
4/7/2020,Q2,5,D,Tuen Mun Ferry Terminal,Departure,0,0,0,0
4/8/2020,Q2,5,D,Airport,Arrival,835,6,24,865
4/8/2020,Q2,5,D,Airport,Departure,361,14,59,434
4/8/2020,Q2,5,D,Express Rail Link West Kowloon,Arrival,0,0,0,0
4/8/2020,Q2,5,D,Express Rail Link West Kowloon,Departure,0,0,0,0
4/8/2020,Q2,5,D,Hung Hom,Arrival,0,0,0,0
4/8/2020,Q2,5,D,Hung Hom,Departure,0,0,0,0
4/8/2020,Q2,5,D,Lo Wu,Arrival,0,0,0,0
4/8/2020,Q2,5,D,Lo Wu,Departure,0,0,0,0
4/8/2020,Q2,5,D,Lok Ma Chau Spur Line,Arrival,0,0,0,0
4/8/2020,Q2,5,D,Lok Ma Chau Spur Line,Departure,0,0,0,0
4/8/2020,Q2,5,D,Hong Kong-Zhuhai-Macao Bridge,Arrival,24,3,0,27
4/8/2020,Q2,5,D,Hong Kong-Zhuhai-Macao Bridge,Departure,24,2,1,27
4/8/2020,Q2,5,D,Lok Ma Chau,Arrival,0,0,0,0
4/8/2020,Q2,5,D,Lok Ma Chau,Departure,0,0,0,0
4/8/2020,Q2,5,D,Man Kam To,Arrival,0,0,0,0
4/8/2020,Q2,5,D,Man Kam To,Departure,0,0,0,0
4/8/2020,Q2,5,D,Sha Tau Kok,Arrival,0,0,0,0
4/8/2020,Q2,5,D,Sha Tau Kok,Departure,0,0,0,0
4/8/2020,Q2,5,D,Shenzhen Bay,Arrival,587,96,1,684
4/8/2020,Q2,5,D,Shenzhen Bay,Departure,314,77,3,394
4/8/2020,Q2,5,D,China Ferry Terminal,Arrival,0,0,0,0
4/8/2020,Q2,5,D,China Ferry Terminal,Departure,0,0,0,0
4/8/2020,Q2,5,D,Harbour Control,Arrival,0,0,0,0
4/8/2020,Q2,5,D,Harbour Control,Departure,0,0,0,0
4/8/2020,Q2,5,D,Kai Tak Cruise Terminal,Arrival,0,0,0,0
4/8/2020,Q2,5,D,Kai Tak Cruise Terminal,Departure,0,0,0,0
4/8/2020,Q2,5,D,Macau Ferry Terminal,Arrival,0,0,0,0
4/8/2020,Q2,5,D,Macau Ferry Terminal,Departure,0,0,0,0
4/8/2020,Q2,5,D,Tuen Mun Ferry Terminal,Arrival,0,0,0,0
4/8/2020,Q2,5,D,Tuen Mun Ferry Terminal,Departure,0,0,0,0
4/9/2020,Q2,5,D,Airport,Arrival,439,0,17,456
4/9/2020,Q2,5,D,Airport,Departure,189,3,39,231
4/9/2020,Q2,5,D,Express Rail Link West Kowloon,Arrival,0,0,0,0
4/9/2020,Q2,5,D,Express Rail Link West Kowloon,Departure,0,0,0,0
4/9/2020,Q2,5,D,Hung Hom,Arrival,0,0,0,0
4/9/2020,Q2,5,D,Hung Hom,Departure,0,0,0,0
4/9/2020,Q2,5,D,Lo Wu,Arrival,0,0,0,0
4/9/2020,Q2,5,D,Lo Wu,Departure,0,0,0,0
4/9/2020,Q2,5,D,Lok Ma Chau Spur Line,Arrival,0,0,0,0
4/9/2020,Q2,5,D,Lok Ma Chau Spur Line,Departure,0,0,0,0
4/9/2020,Q2,5,D,Hong Kong-Zhuhai-Macao Bridge,Arrival,33,8,0,41
4/9/2020,Q2,5,D,Hong Kong-Zhuhai-Macao Bridge,Departure,16,7,2,25
4/9/2020,Q2,5,D,Lok Ma Chau,Arrival,0,0,0,0
4/9/2020,Q2,5,D,Lok Ma Chau,Departure,0,0,0,0
4/9/2020,Q2,5,D,Man Kam To,Arrival,0,0,0,0
4/9/2020,Q2,5,D,Man Kam To,Departure,0,0,0,0
4/9/2020,Q2,5,D,Sha Tau Kok,Arrival,0,0,0,0
4/9/2020,Q2,5,D,Sha Tau Kok,Departure,0,0,0,0
4/9/2020,Q2,5,D,Shenzhen Bay,Arrival,584,85,1,670
4/9/2020,Q2,5,D,Shenzhen Bay,Departure,349,122,3,474
4/9/2020,Q2,5,D,China Ferry Terminal,Arrival,0,0,0,0
4/9/2020,Q2,5,D,China Ferry Terminal,Departure,0,0,0,0
4/9/2020,Q2,5,D,Harbour Control,Arrival,0,0,0,0
4/9/2020,Q2,5,D,Harbour Control,Departure,0,0,0,0
4/9/2020,Q2,5,D,Kai Tak Cruise Terminal,Arrival,0,0,0,0
4/9/2020,Q2,5,D,Kai Tak Cruise Terminal,Departure,0,0,0,0
4/9/2020,Q2,5,D,Macau Ferry Terminal,Arrival,0,0,0,0
4/9/2020,Q2,5,D,Macau Ferry Terminal,Departure,0,0,0,0
4/9/2020,Q2,5,D,Tuen Mun Ferry Terminal,Arrival,0,0,0,0
4/9/2020,Q2,5,D,Tuen Mun Ferry Terminal,Departure,0,0,0,0
4/10/2020,Q2,5,C,Airport,Arrival,811,9,39,859
4/10/2020,Q2,5,C,Airport,Departure,503,20,74,597
4/10/2020,Q2,5,C,Express Rail Link West Kowloon,Arrival,0,0,0,0
4/10/2020,Q2,5,C,Express Rail Link West Kowloon,Departure,0,0,0,0
4/10/2020,Q2,5,C,Hung Hom,Arrival,0,0,0,0
4/10/2020,Q2,5,C,Hung Hom,Departure,0,0,0,0
4/10/2020,Q2,5,C,Lo Wu,Arrival,0,0,0,0
4/10/2020,Q2,5,C,Lo Wu,Departure,0,0,0,0
4/10/2020,Q2,5,C,Lok Ma Chau Spur Line,Arrival,0,0,0,0
4/10/2020,Q2,5,C,Lok Ma Chau Spur Line,Departure,0,0,0,0
4/10/2020,Q2,5,C,Hong Kong-Zhuhai-Macao Bridge,Arrival,36,6,0,42
4/10/2020,Q2,5,C,Hong Kong-Zhuhai-Macao Bridge,Departure,16,3,3,22
4/10/2020,Q2,5,C,Lok Ma Chau,Arrival,0,0,0,0
4/10/2020,Q2,5,C,Lok Ma Chau,Departure,0,0,0,0
4/10/2020,Q2,5,C,Man Kam To,Arrival,0,0,0,0
4/10/2020,Q2,5,C,Man Kam To,Departure,0,0,0,0
4/10/2020,Q2,5,C,Sha Tau Kok,Arrival,0,0,0,0
4/10/2020,Q2,5,C,Sha Tau Kok,Departure,0,0,0,0
4/10/2020,Q2,5,C,Shenzhen Bay,Arrival,613,131,1,745
4/10/2020,Q2,5,C,Shenzhen Bay,Departure,397,129,1,527
4/10/2020,Q2,5,C,China Ferry Terminal,Arrival,0,0,0,0
4/10/2020,Q2,5,C,China Ferry Terminal,Departure,0,0,0,0
4/10/2020,Q2,5,C,Harbour Control,Arrival,0,0,0,0
4/10/2020,Q2,5,C,Harbour Control,Departure,0,0,0,0
4/10/2020,Q2,5,C,Kai Tak Cruise Terminal,Arrival,0,0,0,0
4/10/2020,Q2,5,C,Kai Tak Cruise Terminal,Departure,0,0,0,0
4/10/2020,Q2,5,C,Macau Ferry Terminal,Arrival,0,0,0,0
4/10/2020,Q2,5,C,Macau Ferry Terminal,Departure,0,0,0,0
4/10/2020,Q2,5,C,Tuen Mun Ferry Terminal,Arrival,0,0,0,0
4/10/2020,Q2,5,C,Tuen Mun Ferry Terminal,Departure,0,0,0,0
4/11/2020,Q2,5,C,Airport,Arrival,220,0,8,228
4/11/2020,Q2,5,C,Airport,Departure,195,4,33,232
4/11/2020,Q2,5,C,Express Rail Link West Kowloon,Arrival,0,0,0,0
4/11/2020,Q2,5,C,Express Rail Link West Kowloon,Departure,0,0,0,0
4/11/2020,Q2,5,C,Hung Hom,Arrival,0,0,0,0
4/11/2020,Q2,5,C,Hung Hom,Departure,0,0,0,0
4/11/2020,Q2,5,C,Lo Wu,Arrival,0,0,0,0
4/11/2020,Q2,5,C,Lo Wu,Departure,0,0,0,0
4/11/2020,Q2,5,C,Lok Ma Chau Spur Line,Arrival,0,0,0,0
4/11/2020,Q2,5,C,Lok Ma Chau Spur Line,Departure,0,0,0,0
4/11/2020,Q2,5,C,Hong Kong-Zhuhai-Macao Bridge,Arrival,22,9,4,35
4/11/2020,Q2,5,C,Hong Kong-Zhuhai-Macao Bridge,Departure,23,2,2,27
4/11/2020,Q2,5,C,Lok Ma Chau,Arrival,0,0,0,0
4/11/2020,Q2,5,C,Lok Ma Chau,Departure,0,0,0,0
4/11/2020,Q2,5,C,Man Kam To,Arrival,0,0,0,0
4/11/2020,Q2,5,C,Man Kam To,Departure,0,0,0,0
4/11/2020,Q2,5,C,Sha Tau Kok,Arrival,0,0,0,0
4/11/2020,Q2,5,C,Sha Tau Kok,Departure,0,0,0,0
4/11/2020,Q2,5,C,Shenzhen Bay,Arrival,590,102,5,697
4/11/2020,Q2,5,C,Shenzhen Bay,Departure,306,58,2,366
4/11/2020,Q2,5,C,China Ferry Terminal,Arrival,0,0,0,0
4/11/2020,Q2,5,C,China Ferry Terminal,Departure,0,0,0,0
4/11/2020,Q2,5,C,Harbour Control,Arrival,0,0,0,0
4/11/2020,Q2,5,C,Harbour Control,Departure,0,0,0,0
4/11/2020,Q2,5,C,Kai Tak Cruise Terminal,Arrival,0,0,0,0
4/11/2020,Q2,5,C,Kai Tak Cruise Terminal,Departure,0,0,0,0
4/11/2020,Q2,5,C,Macau Ferry Terminal,Arrival,0,0,0,0
4/11/2020,Q2,5,C,Macau Ferry Terminal,Departure,0,0,0,0
4/11/2020,Q2,5,C,Tuen Mun Ferry Terminal,Arrival,0,0,0,0
4/11/2020,Q2,5,C,Tuen Mun Ferry Terminal,Departure,0,0,0,0
4/12/2020,Q2,5,C,Airport,Arrival,544,4,24,572
4/12/2020,Q2,5,C,Airport,Departure,352,30,54,436
4/12/2020,Q2,5,C,Express Rail Link West Kowloon,Arrival,0,0,0,0
4/12/2020,Q2,5,C,Express Rail Link West Kowloon,Departure,0,0,0,0
4/12/2020,Q2,5,C,Hung Hom,Arrival,0,0,0,0
4/12/2020,Q2,5,C,Hung Hom,Departure,0,0,0,0
4/12/2020,Q2,5,C,Lo Wu,Arrival,0,0,0,0
4/12/2020,Q2,5,C,Lo Wu,Departure,0,0,0,0
4/12/2020,Q2,5,C,Lok Ma Chau Spur Line,Arrival,0,0,0,0
4/12/2020,Q2,5,C,Lok Ma Chau Spur Line,Departure,0,0,0,0
4/12/2020,Q2,5,C,Hong Kong-Zhuhai-Macao Bridge,Arrival,49,4,1,54
4/12/2020,Q2,5,C,Hong Kong-Zhuhai-Macao Bridge,Departure,10,0,0,10
4/12/2020,Q2,5,C,Lok Ma Chau,Arrival,0,0,0,0
4/12/2020,Q2,5,C,Lok Ma Chau,Departure,0,0,0,0
4/12/2020,Q2,5,C,Man Kam To,Arrival,0,0,0,0
4/12/2020,Q2,5,C,Man Kam To,Departure,0,0,0,0
4/12/2020,Q2,5,C,Sha Tau Kok,Arrival,0,0,0,0
4/12/2020,Q2,5,C,Sha Tau Kok,Departure,0,0,0,0
4/12/2020,Q2,5,C,Shenzhen Bay,Arrival,455,99,1,555
4/12/2020,Q2,5,C,Shenzhen Bay,Departure,258,57,1,316
4/12/2020,Q2,5,C,China Ferry Terminal,Arrival,0,0,0,0
4/12/2020,Q2,5,C,China Ferry Terminal,Departure,0,0,0,0
4/12/2020,Q2,5,C,Harbour Control,Arrival,0,0,0,0
4/12/2020,Q2,5,C,Harbour Control,Departure,0,0,0,0
4/12/2020,Q2,5,C,Kai Tak Cruise Terminal,Arrival,0,0,0,0
4/12/2020,Q2,5,C,Kai Tak Cruise Terminal,Departure,0,0,0,0
4/12/2020,Q2,5,C,Macau Ferry Terminal,Arrival,0,0,0,0
4/12/2020,Q2,5,C,Macau Ferry Terminal,Departure,0,0,0,0
4/12/2020,Q2,5,C,Tuen Mun Ferry Terminal,Arrival,0,0,0,0
4/12/2020,Q2,5,C,Tuen Mun Ferry Terminal,Departure,0,0,0,0
4/13/2020,Q2,5,C,Airport,Arrival,395,1,18,414
4/13/2020,Q2,5,C,Airport,Departure,71,6,28,105
4/13/2020,Q2,5,C,Express Rail Link West Kowloon,Arrival,0,0,0,0
4/13/2020,Q2,5,C,Express Rail Link West Kowloon,Departure,0,0,0,0
4/13/2020,Q2,5,C,Hung Hom,Arrival,0,0,0,0
4/13/2020,Q2,5,C,Hung Hom,Departure,0,0,0,0
4/13/2020,Q2,5,C,Lo Wu,Arrival,0,0,0,0
4/13/2020,Q2,5,C,Lo Wu,Departure,0,0,0,0
4/13/2020,Q2,5,C,Lok Ma Chau Spur Line,Arrival,0,0,0,0
4/13/2020,Q2,5,C,Lok Ma Chau Spur Line,Departure,0,0,0,0
4/13/2020,Q2,5,C,Hong Kong-Zhuhai-Macao Bridge,Arrival,51,3,0,54
4/13/2020,Q2,5,C,Hong Kong-Zhuhai-Macao Bridge,Departure,17,1,1,19
4/13/2020,Q2,5,C,Lok Ma Chau,Arrival,0,0,0,0
4/13/2020,Q2,5,C,Lok Ma Chau,Departure,0,0,0,0
4/13/2020,Q2,5,C,Man Kam To,Arrival,0,0,0,0
4/13/2020,Q2,5,C,Man Kam To,Departure,0,0,0,0
4/13/2020,Q2,5,C,Sha Tau Kok,Arrival,0,0,0,0
4/13/2020,Q2,5,C,Sha Tau Kok,Departure,0,0,0,0
4/13/2020,Q2,5,C,Shenzhen Bay,Arrival,511,98,5,614
4/13/2020,Q2,5,C,Shenzhen Bay,Departure,273,72,4,349
4/13/2020,Q2,5,C,China Ferry Terminal,Arrival,0,0,0,0
4/13/2020,Q2,5,C,China Ferry Terminal,Departure,0,0,0,0
4/13/2020,Q2,5,C,Harbour Control,Arrival,0,0,0,0
4/13/2020,Q2,5,C,Harbour Control,Departure,0,0,0,0
4/13/2020,Q2,5,C,Kai Tak Cruise Terminal,Arrival,0,0,0,0
4/13/2020,Q2,5,C,Kai Tak Cruise Terminal,Departure,0,0,0,0
4/13/2020,Q2,5,C,Macau Ferry Terminal,Arrival,0,0,0,0
4/13/2020,Q2,5,C,Macau Ferry Terminal,Departure,0,0,0,0
4/13/2020,Q2,5,C,Tuen Mun Ferry Terminal,Arrival,0,0,0,0
4/13/2020,Q2,5,C,Tuen Mun Ferry Terminal,Departure,0,0,0,0
4/14/2020,Q2,5,C,Airport,Arrival,430,7,10,447
4/14/2020,Q2,5,C,Airport,Departure,150,10,50,210
4/14/2020,Q2,5,C,Express Rail Link West Kowloon,Arrival,0,0,0,0
4/14/2020,Q2,5,C,Express Rail Link West Kowloon,Departure,0,0,0,0
4/14/2020,Q2,5,C,Hung Hom,Arrival,0,0,0,0
4/14/2020,Q2,5,C,Hung Hom,Departure,0,0,0,0
4/14/2020,Q2,5,C,Lo Wu,Arrival,0,0,0,0
4/14/2020,Q2,5,C,Lo Wu,Departure,0,0,0,0
4/14/2020,Q2,5,C,Lok Ma Chau Spur Line,Arrival,0,0,0,0
4/14/2020,Q2,5,C,Lok Ma Chau Spur Line,Departure,0,0,0,0
4/14/2020,Q2,5,C,Hong Kong-Zhuhai-Macao Bridge,Arrival,36,4,1,41
4/14/2020,Q2,5,C,Hong Kong-Zhuhai-Macao Bridge,Departure,21,5,3,29
4/14/2020,Q2,5,C,Lok Ma Chau,Arrival,0,0,0,0
4/14/2020,Q2,5,C,Lok Ma Chau,Departure,0,0,0,0
4/14/2020,Q2,5,C,Man Kam To,Arrival,0,0,0,0
4/14/2020,Q2,5,C,Man Kam To,Departure,0,0,0,0
4/14/2020,Q2,5,C,Sha Tau Kok,Arrival,0,0,0,0
4/14/2020,Q2,5,C,Sha Tau Kok,Departure,0,0,0,0
4/14/2020,Q2,5,C,Shenzhen Bay,Arrival,588,70,0,658
4/14/2020,Q2,5,C,Shenzhen Bay,Departure,275,64,1,340
4/14/2020,Q2,5,C,China Ferry Terminal,Arrival,0,0,0,0
4/14/2020,Q2,5,C,China Ferry Terminal,Departure,0,0,0,0
4/14/2020,Q2,5,C,Harbour Control,Arrival,0,0,0,0
4/14/2020,Q2,5,C,Harbour Control,Departure,0,0,0,0
4/14/2020,Q2,5,C,Kai Tak Cruise Terminal,Arrival,0,0,0,0
4/14/2020,Q2,5,C,Kai Tak Cruise Terminal,Departure,0,0,0,0
4/14/2020,Q2,5,C,Macau Ferry Terminal,Arrival,0,0,0,0
4/14/2020,Q2,5,C,Macau Ferry Terminal,Departure,0,0,0,0
4/14/2020,Q2,5,C,Tuen Mun Ferry Terminal,Arrival,0,0,0,0
4/14/2020,Q2,5,C,Tuen Mun Ferry Terminal,Departure,0,0,0,0
4/15/2020,Q2,5,C,Airport,Arrival,481,2,16,499
4/15/2020,Q2,5,C,Airport,Departure,331,12,60,403
4/15/2020,Q2,5,C,Express Rail Link West Kowloon,Arrival,0,0,0,0
4/15/2020,Q2,5,C,Express Rail Link West Kowloon,Departure,0,0,0,0
4/15/2020,Q2,5,C,Hung Hom,Arrival,0,0,0,0
4/15/2020,Q2,5,C,Hung Hom,Departure,0,0,0,0
4/15/2020,Q2,5,C,Lo Wu,Arrival,0,0,0,0
4/15/2020,Q2,5,C,Lo Wu,Departure,0,0,0,0
4/15/2020,Q2,5,C,Lok Ma Chau Spur Line,Arrival,0,0,0,0
4/15/2020,Q2,5,C,Lok Ma Chau Spur Line,Departure,0,0,0,0
4/15/2020,Q2,5,C,Hong Kong-Zhuhai-Macao Bridge,Arrival,33,4,1,38
4/15/2020,Q2,5,C,Hong Kong-Zhuhai-Macao Bridge,Departure,17,3,0,20
4/15/2020,Q2,5,C,Lok Ma Chau,Arrival,0,0,0,0
4/15/2020,Q2,5,C,Lok Ma Chau,Departure,0,0,0,0
4/15/2020,Q2,5,C,Man Kam To,Arrival,0,0,0,0
4/15/2020,Q2,5,C,Man Kam To,Departure,0,0,0,0
4/15/2020,Q2,5,C,Sha Tau Kok,Arrival,0,0,0,0
4/15/2020,Q2,5,C,Sha Tau Kok,Departure,0,0,0,0
4/15/2020,Q2,5,C,Shenzhen Bay,Arrival,613,93,1,707
4/15/2020,Q2,5,C,Shenzhen Bay,Departure,240,69,2,311
4/15/2020,Q2,5,C,China Ferry Terminal,Arrival,0,0,0,0
4/15/2020,Q2,5,C,China Ferry Terminal,Departure,0,0,0,0
4/15/2020,Q2,5,C,Harbour Control,Arrival,0,0,0,0
4/15/2020,Q2,5,C,Harbour Control,Departure,0,0,0,0
4/15/2020,Q2,5,C,Kai Tak Cruise Terminal,Arrival,0,0,0,0
4/15/2020,Q2,5,C,Kai Tak Cruise Terminal,Departure,0,0,0,0
4/15/2020,Q2,5,C,Macau Ferry Terminal,Arrival,0,0,0,0
4/15/2020,Q2,5,C,Macau Ferry Terminal,Departure,0,0,0,0
4/15/2020,Q2,5,C,Tuen Mun Ferry Terminal,Arrival,0,0,0,0
4/15/2020,Q2,5,C,Tuen Mun Ferry Terminal,Departure,0,0,0,0
4/16/2020,Q2,5,C,Airport,Arrival,397,1,19,417
4/16/2020,Q2,5,C,Airport,Departure,147,15,24,186
4/16/2020,Q2,5,C,Express Rail Link West Kowloon,Arrival,0,0,0,0
4/16/2020,Q2,5,C,Express Rail Link West Kowloon,Departure,0,0,0,0
4/16/2020,Q2,5,C,Hung Hom,Arrival,0,0,0,0
4/16/2020,Q2,5,C,Hung Hom,Departure,0,0,0,0
4/16/2020,Q2,5,C,Lo Wu,Arrival,0,0,0,0
4/16/2020,Q2,5,C,Lo Wu,Departure,0,0,0,0
4/16/2020,Q2,5,C,Lok Ma Chau Spur Line,Arrival,0,0,0,0
4/16/2020,Q2,5,C,Lok Ma Chau Spur Line,Departure,0,0,0,0
4/16/2020,Q2,5,C,Hong Kong-Zhuhai-Macao Bridge,Arrival,26,2,0,28
4/16/2020,Q2,5,C,Hong Kong-Zhuhai-Macao Bridge,Departure,11,0,1,12
4/16/2020,Q2,5,C,Lok Ma Chau,Arrival,0,0,0,0
4/16/2020,Q2,5,C,Lok Ma Chau,Departure,0,0,0,0
4/16/2020,Q2,5,C,Man Kam To,Arrival,0,0,0,0
4/16/2020,Q2,5,C,Man Kam To,Departure,0,0,0,0
4/16/2020,Q2,5,C,Sha Tau Kok,Arrival,0,0,0,0
4/16/2020,Q2,5,C,Sha Tau Kok,Departure,0,0,0,0
4/16/2020,Q2,5,C,Shenzhen Bay,Arrival,527,81,3,611
4/16/2020,Q2,5,C,Shenzhen Bay,Departure,223,56,0,279
4/16/2020,Q2,5,C,China Ferry Terminal,Arrival,0,0,0,0
4/16/2020,Q2,5,C,China Ferry Terminal,Departure,0,0,0,0
4/16/2020,Q2,5,C,Harbour Control,Arrival,0,0,0,0
4/16/2020,Q2,5,C,Harbour Control,Departure,0,0,0,0
4/16/2020,Q2,5,C,Kai Tak Cruise Terminal,Arrival,0,0,0,0
4/16/2020,Q2,5,C,Kai Tak Cruise Terminal,Departure,0,0,0,0
4/16/2020,Q2,5,C,Macau Ferry Terminal,Arrival,0,0,0,0
4/16/2020,Q2,5,C,Macau Ferry Terminal,Departure,0,0,0,0
4/16/2020,Q2,5,C,Tuen Mun Ferry Terminal,Arrival,0,0,0,0
4/16/2020,Q2,5,C,Tuen Mun Ferry Terminal,Departure,0,0,0,0
4/17/2020,Q2,5,C,Airport,Arrival,820,6,20,846
4/17/2020,Q2,5,C,Airport,Departure,507,15,80,602
4/17/2020,Q2,5,C,Express Rail Link West Kowloon,Arrival,0,0,0,0
4/17/2020,Q2,5,C,Express Rail Link West Kowloon,Departure,0,0,0,0
4/17/2020,Q2,5,C,Hung Hom,Arrival,0,0,0,0
4/17/2020,Q2,5,C,Hung Hom,Departure,0,0,0,0
4/17/2020,Q2,5,C,Lo Wu,Arrival,0,0,0,0
4/17/2020,Q2,5,C,Lo Wu,Departure,0,0,0,0
4/17/2020,Q2,5,C,Lok Ma Chau Spur Line,Arrival,0,0,0,0
4/17/2020,Q2,5,C,Lok Ma Chau Spur Line,Departure,0,0,0,0
4/17/2020,Q2,5,C,Hong Kong-Zhuhai-Macao Bridge,Arrival,24,4,2,30
4/17/2020,Q2,5,C,Hong Kong-Zhuhai-Macao Bridge,Departure,27,2,2,31
4/17/2020,Q2,5,C,Lok Ma Chau,Arrival,0,0,0,0
4/17/2020,Q2,5,C,Lok Ma Chau,Departure,0,0,0,0
4/17/2020,Q2,5,C,Man Kam To,Arrival,0,0,0,0
4/17/2020,Q2,5,C,Man Kam To,Departure,0,0,0,0
4/17/2020,Q2,5,C,Sha Tau Kok,Arrival,0,0,0,0
4/17/2020,Q2,5,C,Sha Tau Kok,Departure,0,0,0,0
4/17/2020,Q2,5,C,Shenzhen Bay,Arrival,519,77,4,600
4/17/2020,Q2,5,C,Shenzhen Bay,Departure,180,54,4,238
4/17/2020,Q2,5,C,China Ferry Terminal,Arrival,0,0,0,0
4/17/2020,Q2,5,C,China Ferry Terminal,Departure,0,0,0,0
4/17/2020,Q2,5,C,Harbour Control,Arrival,0,0,0,0
4/17/2020,Q2,5,C,Harbour Control,Departure,0,0,0,0
4/17/2020,Q2,5,C,Kai Tak Cruise Terminal,Arrival,0,0,0,0
4/17/2020,Q2,5,C,Kai Tak Cruise Terminal,Departure,0,0,0,0
4/17/2020,Q2,5,C,Macau Ferry Terminal,Arrival,0,0,0,0
4/17/2020,Q2,5,C,Macau Ferry Terminal,Departure,0,0,0,0
4/17/2020,Q2,5,C,Tuen Mun Ferry Terminal,Arrival,0,0,0,0
4/17/2020,Q2,5,C,Tuen Mun Ferry Terminal,Departure,0,0,0,0
4/18/2020,Q2,5,C,Airport,Arrival,373,9,14,396
4/18/2020,Q2,5,C,Airport,Departure,336,19,67,422
4/18/2020,Q2,5,C,Express Rail Link West Kowloon,Arrival,0,0,0,0
4/18/2020,Q2,5,C,Express Rail Link West Kowloon,Departure,0,0,0,0
4/18/2020,Q2,5,C,Hung Hom,Arrival,0,0,0,0
4/18/2020,Q2,5,C,Hung Hom,Departure,0,0,0,0
4/18/2020,Q2,5,C,Lo Wu,Arrival,0,0,0,0
4/18/2020,Q2,5,C,Lo Wu,Departure,0,0,0,0
4/18/2020,Q2,5,C,Lok Ma Chau Spur Line,Arrival,0,0,0,0
4/18/2020,Q2,5,C,Lok Ma Chau Spur Line,Departure,0,0,0,0
4/18/2020,Q2,5,C,Hong Kong-Zhuhai-Macao Bridge,Arrival,33,8,1,42
4/18/2020,Q2,5,C,Hong Kong-Zhuhai-Macao Bridge,Departure,11,4,6,21
4/18/2020,Q2,5,C,Lok Ma Chau,Arrival,0,0,0,0
4/18/2020,Q2,5,C,Lok Ma Chau,Departure,0,0,0,0
4/18/2020,Q2,5,C,Man Kam To,Arrival,0,0,0,0
4/18/2020,Q2,5,C,Man Kam To,Departure,0,0,0,0
4/18/2020,Q2,5,C,Sha Tau Kok,Arrival,0,0,0,0
4/18/2020,Q2,5,C,Sha Tau Kok,Departure,0,0,0,0
4/18/2020,Q2,5,C,Shenzhen Bay,Arrival,456,86,0,542
4/18/2020,Q2,5,C,Shenzhen Bay,Departure,194,65,4,263
4/18/2020,Q2,5,C,China Ferry Terminal,Arrival,0,0,0,0
4/18/2020,Q2,5,C,China Ferry Terminal,Departure,0,0,0,0
4/18/2020,Q2,5,C,Harbour Control,Arrival,0,0,0,0
4/18/2020,Q2,5,C,Harbour Control,Departure,0,0,0,0
4/18/2020,Q2,5,C,Kai Tak Cruise Terminal,Arrival,0,0,0,0
4/18/2020,Q2,5,C,Kai Tak Cruise Terminal,Departure,0,0,0,0
4/18/2020,Q2,5,C,Macau Ferry Terminal,Arrival,0,0,0,0
4/18/2020,Q2,5,C,Macau Ferry Terminal,Departure,0,0,0,0
4/18/2020,Q2,5,C,Tuen Mun Ferry Terminal,Arrival,0,0,0,0
4/18/2020,Q2,5,C,Tuen Mun Ferry Terminal,Departure,0,0,0,0
4/19/2020,Q2,5,C,Airport,Arrival,452,2,13,467
4/19/2020,Q2,5,C,Airport,Departure,273,2,44,319
4/19/2020,Q2,5,C,Express Rail Link West Kowloon,Arrival,0,0,0,0
4/19/2020,Q2,5,C,Express Rail Link West Kowloon,Departure,0,0,0,0
4/19/2020,Q2,5,C,Hung Hom,Arrival,0,0,0,0
4/19/2020,Q2,5,C,Hung Hom,Departure,0,0,0,0
4/19/2020,Q2,5,C,Lo Wu,Arrival,0,0,0,0
4/19/2020,Q2,5,C,Lo Wu,Departure,0,0,0,0
4/19/2020,Q2,5,C,Lok Ma Chau Spur Line,Arrival,0,0,0,0
4/19/2020,Q2,5,C,Lok Ma Chau Spur Line,Departure,0,0,0,0
4/19/2020,Q2,5,C,Hong Kong-Zhuhai-Macao Bridge,Arrival,21,1,0,22
4/19/2020,Q2,5,C,Hong Kong-Zhuhai-Macao Bridge,Departure,7,0,0,7
4/19/2020,Q2,5,C,Lok Ma Chau,Arrival,0,0,0,0
4/19/2020,Q2,5,C,Lok Ma Chau,Departure,0,0,0,0
4/19/2020,Q2,5,C,Man Kam To,Arrival,0,0,0,0
4/19/2020,Q2,5,C,Man Kam To,Departure,0,0,0,0
4/19/2020,Q2,5,C,Sha Tau Kok,Arrival,0,0,0,0
4/19/2020,Q2,5,C,Sha Tau Kok,Departure,0,0,0,0
4/19/2020,Q2,5,C,Shenzhen Bay,Arrival,543,96,3,642
4/19/2020,Q2,5,C,Shenzhen Bay,Departure,168,53,0,221
4/19/2020,Q2,5,C,China Ferry Terminal,Arrival,0,0,0,0
4/19/2020,Q2,5,C,China Ferry Terminal,Departure,0,0,0,0
4/19/2020,Q2,5,C,Harbour Control,Arrival,0,0,0,0
4/19/2020,Q2,5,C,Harbour Control,Departure,0,0,0,0
4/19/2020,Q2,5,C,Kai Tak Cruise Terminal,Arrival,0,0,0,0
4/19/2020,Q2,5,C,Kai Tak Cruise Terminal,Departure,0,0,0,0
4/19/2020,Q2,5,C,Macau Ferry Terminal,Arrival,0,0,0,0
4/19/2020,Q2,5,C,Macau Ferry Terminal,Departure,0,0,0,0
4/19/2020,Q2,5,C,Tuen Mun Ferry Terminal,Arrival,0,0,0,0
4/19/2020,Q2,5,C,Tuen Mun Ferry Terminal,Departure,0,0,0,0
4/20/2020,Q2,5,C,Airport,Arrival,460,6,20,486
4/20/2020,Q2,5,C,Airport,Departure,190,26,25,241
4/20/2020,Q2,5,C,Express Rail Link West Kowloon,Arrival,0,0,0,0
4/20/2020,Q2,5,C,Express Rail Link West Kowloon,Departure,0,0,0,0
4/20/2020,Q2,5,C,Hung Hom,Arrival,0,0,0,0
4/20/2020,Q2,5,C,Hung Hom,Departure,0,0,0,0
4/20/2020,Q2,5,C,Lo Wu,Arrival,0,0,0,0
4/20/2020,Q2,5,C,Lo Wu,Departure,0,0,0,0
4/20/2020,Q2,5,C,Lok Ma Chau Spur Line,Arrival,0,0,0,0
4/20/2020,Q2,5,C,Lok Ma Chau Spur Line,Departure,0,0,0,0
4/20/2020,Q2,5,C,Hong Kong-Zhuhai-Macao Bridge,Arrival,40,0,1,41
4/20/2020,Q2,5,C,Hong Kong-Zhuhai-Macao Bridge,Departure,12,1,0,13
4/20/2020,Q2,5,C,Lok Ma Chau,Arrival,0,0,0,0
4/20/2020,Q2,5,C,Lok Ma Chau,Departure,0,0,0,0
4/20/2020,Q2,5,C,Man Kam To,Arrival,0,0,0,0
4/20/2020,Q2,5,C,Man Kam To,Departure,0,0,0,0
4/20/2020,Q2,5,C,Sha Tau Kok,Arrival,0,0,0,0
4/20/2020,Q2,5,C,Sha Tau Kok,Departure,0,0,0,0
4/20/2020,Q2,5,C,Shenzhen Bay,Arrival,663,80,2,745
4/20/2020,Q2,5,C,Shenzhen Bay,Departure,306,73,7,386
4/20/2020,Q2,5,C,China Ferry Terminal,Arrival,0,0,0,0
4/20/2020,Q2,5,C,China Ferry Terminal,Departure,0,0,0,0
4/20/2020,Q2,5,C,Harbour Control,Arrival,0,0,0,0
4/20/2020,Q2,5,C,Harbour Control,Departure,0,0,0,0
4/20/2020,Q2,5,C,Kai Tak Cruise Terminal,Arrival,0,0,0,0
4/20/2020,Q2,5,C,Kai Tak Cruise Terminal,Departure,0,0,0,0
4/20/2020,Q2,5,C,Macau Ferry Terminal,Arrival,0,0,0,0
4/20/2020,Q2,5,C,Macau Ferry Terminal,Departure,0,0,0,0
4/20/2020,Q2,5,C,Tuen Mun Ferry Terminal,Arrival,0,0,0,0
4/20/2020,Q2,5,C,Tuen Mun Ferry Terminal,Departure,0,0,0,0
4/21/2020,Q2,5,C,Airport,Arrival,324,3,22,349
4/21/2020,Q2,5,C,Airport,Departure,86,3,28,117
4/21/2020,Q2,5,C,Express Rail Link West Kowloon,Arrival,0,0,0,0
4/21/2020,Q2,5,C,Express Rail Link West Kowloon,Departure,0,0,0,0
4/21/2020,Q2,5,C,Hung Hom,Arrival,0,0,0,0
4/21/2020,Q2,5,C,Hung Hom,Departure,0,0,0,0
4/21/2020,Q2,5,C,Lo Wu,Arrival,0,0,0,0
4/21/2020,Q2,5,C,Lo Wu,Departure,0,0,0,0
4/21/2020,Q2,5,C,Lok Ma Chau Spur Line,Arrival,0,0,0,0
4/21/2020,Q2,5,C,Lok Ma Chau Spur Line,Departure,0,0,0,0
4/21/2020,Q2,5,C,Hong Kong-Zhuhai-Macao Bridge,Arrival,24,4,0,28
4/21/2020,Q2,5,C,Hong Kong-Zhuhai-Macao Bridge,Departure,24,5,2,31
4/21/2020,Q2,5,C,Lok Ma Chau,Arrival,0,0,0,0
4/21/2020,Q2,5,C,Lok Ma Chau,Departure,0,0,0,0
4/21/2020,Q2,5,C,Man Kam To,Arrival,0,0,0,0
4/21/2020,Q2,5,C,Man Kam To,Departure,0,0,0,0
4/21/2020,Q2,5,C,Sha Tau Kok,Arrival,0,0,0,0
4/21/2020,Q2,5,C,Sha Tau Kok,Departure,0,0,0,0
4/21/2020,Q2,5,C,Shenzhen Bay,Arrival,438,66,1,505
4/21/2020,Q2,5,C,Shenzhen Bay,Departure,213,37,1,251
4/21/2020,Q2,5,C,China Ferry Terminal,Arrival,0,0,0,0
4/21/2020,Q2,5,C,China Ferry Terminal,Departure,0,0,0,0
4/21/2020,Q2,5,C,Harbour Control,Arrival,0,0,0,0
4/21/2020,Q2,5,C,Harbour Control,Departure,0,0,0,0
4/21/2020,Q2,5,C,Kai Tak Cruise Terminal,Arrival,0,0,0,0
4/21/2020,Q2,5,C,Kai Tak Cruise Terminal,Departure,0,0,0,0
4/21/2020,Q2,5,C,Macau Ferry Terminal,Arrival,0,0,0,0
4/21/2020,Q2,5,C,Macau Ferry Terminal,Departure,0,0,0,0
4/21/2020,Q2,5,C,Tuen Mun Ferry Terminal,Arrival,0,0,0,0
4/21/2020,Q2,5,C,Tuen Mun Ferry Terminal,Departure,0,0,0,0
4/22/2020,Q2,5,C,Airport,Arrival,561,2,29,592
4/22/2020,Q2,5,C,Airport,Departure,243,6,57,306
4/22/2020,Q2,5,C,Express Rail Link West Kowloon,Arrival,0,0,0,0
4/22/2020,Q2,5,C,Express Rail Link West Kowloon,Departure,0,0,0,0
4/22/2020,Q2,5,C,Hung Hom,Arrival,0,0,0,0
4/22/2020,Q2,5,C,Hung Hom,Departure,0,0,0,0
4/22/2020,Q2,5,C,Lo Wu,Arrival,0,0,0,0
4/22/2020,Q2,5,C,Lo Wu,Departure,0,0,0,0
4/22/2020,Q2,5,C,Lok Ma Chau Spur Line,Arrival,0,0,0,0
4/22/2020,Q2,5,C,Lok Ma Chau Spur Line,Departure,0,0,0,0
4/22/2020,Q2,5,C,Hong Kong-Zhuhai-Macao Bridge,Arrival,47,3,1,51
4/22/2020,Q2,5,C,Hong Kong-Zhuhai-Macao Bridge,Departure,11,4,1,16
4/22/2020,Q2,5,C,Lok Ma Chau,Arrival,0,0,0,0
4/22/2020,Q2,5,C,Lok Ma Chau,Departure,0,0,0,0
4/22/2020,Q2,5,C,Man Kam To,Arrival,0,0,0,0
4/22/2020,Q2,5,C,Man Kam To,Departure,0,0,0,0
4/22/2020,Q2,5,C,Sha Tau Kok,Arrival,0,0,0,0
4/22/2020,Q2,5,C,Sha Tau Kok,Departure,0,0,0,0
4/22/2020,Q2,5,C,Shenzhen Bay,Arrival,384,60,3,447
4/22/2020,Q2,5,C,Shenzhen Bay,Departure,242,44,0,286
4/22/2020,Q2,5,C,China Ferry Terminal,Arrival,0,0,0,0
4/22/2020,Q2,5,C,China Ferry Terminal,Departure,0,0,0,0
4/22/2020,Q2,5,C,Harbour Control,Arrival,0,0,0,0
4/22/2020,Q2,5,C,Harbour Control,Departure,0,0,0,0
4/22/2020,Q2,5,C,Kai Tak Cruise Terminal,Arrival,0,0,0,0
4/22/2020,Q2,5,C,Kai Tak Cruise Terminal,Departure,0,0,0,0
4/22/2020,Q2,5,C,Macau Ferry Terminal,Arrival,0,0,0,0
4/22/2020,Q2,5,C,Macau Ferry Terminal,Departure,0,0,0,0
4/22/2020,Q2,5,C,Tuen Mun Ferry Terminal,Arrival,0,0,0,0
4/22/2020,Q2,5,C,Tuen Mun Ferry Terminal,Departure,0,0,0,0
4/23/2020,Q2,5,C,Airport,Arrival,241,2,19,262
4/23/2020,Q2,5,C,Airport,Departure,179,13,59,251
4/23/2020,Q2,5,C,Express Rail Link West Kowloon,Arrival,0,0,0,0
4/23/2020,Q2,5,C,Express Rail Link West Kowloon,Departure,0,0,0,0
4/23/2020,Q2,5,C,Hung Hom,Arrival,0,0,0,0
4/23/2020,Q2,5,C,Hung Hom,Departure,0,0,0,0
4/23/2020,Q2,5,C,Lo Wu,Arrival,0,0,0,0
4/23/2020,Q2,5,C,Lo Wu,Departure,0,0,0,0
4/23/2020,Q2,5,C,Lok Ma Chau Spur Line,Arrival,0,0,0,0
4/23/2020,Q2,5,C,Lok Ma Chau Spur Line,Departure,0,0,0,0
4/23/2020,Q2,5,C,Hong Kong-Zhuhai-Macao Bridge,Arrival,24,1,1,26
4/23/2020,Q2,5,C,Hong Kong-Zhuhai-Macao Bridge,Departure,8,1,2,11
4/23/2020,Q2,5,C,Lok Ma Chau,Arrival,0,0,0,0
4/23/2020,Q2,5,C,Lok Ma Chau,Departure,0,0,0,0
4/23/2020,Q2,5,C,Man Kam To,Arrival,0,0,0,0
4/23/2020,Q2,5,C,Man Kam To,Departure,0,0,0,0
4/23/2020,Q2,5,C,Sha Tau Kok,Arrival,0,0,0,0
4/23/2020,Q2,5,C,Sha Tau Kok,Departure,0,0,0,0
4/23/2020,Q2,5,C,Shenzhen Bay,Arrival,351,56,1,408
4/23/2020,Q2,5,C,Shenzhen Bay,Departure,210,64,1,275
4/23/2020,Q2,5,C,China Ferry Terminal,Arrival,0,0,0,0
4/23/2020,Q2,5,C,China Ferry Terminal,Departure,0,0,0,0
4/23/2020,Q2,5,C,Harbour Control,Arrival,0,0,0,0
4/23/2020,Q2,5,C,Harbour Control,Departure,0,0,0,0
4/23/2020,Q2,5,C,Kai Tak Cruise Terminal,Arrival,0,0,0,0
4/23/2020,Q2,5,C,Kai Tak Cruise Terminal,Departure,0,0,0,0
4/23/2020,Q2,5,C,Macau Ferry Terminal,Arrival,0,0,0,0
4/23/2020,Q2,5,C,Macau Ferry Terminal,Departure,0,0,0,0
4/23/2020,Q2,5,C,Tuen Mun Ferry Terminal,Arrival,0,0,0,0
4/23/2020,Q2,5,C,Tuen Mun Ferry Terminal,Departure,0,0,0,0
4/24/2020,Q2,5,C,Airport,Arrival,817,0,26,843
4/24/2020,Q2,5,C,Airport,Departure,374,5,63,442
4/24/2020,Q2,5,C,Express Rail Link West Kowloon,Arrival,0,0,0,0
4/24/2020,Q2,5,C,Express Rail Link West Kowloon,Departure,0,0,0,0
4/24/2020,Q2,5,C,Hung Hom,Arrival,0,0,0,0
4/24/2020,Q2,5,C,Hung Hom,Departure,0,0,0,0
4/24/2020,Q2,5,C,Lo Wu,Arrival,0,0,0,0
4/24/2020,Q2,5,C,Lo Wu,Departure,0,0,0,0
4/24/2020,Q2,5,C,Lok Ma Chau Spur Line,Arrival,0,0,0,0
4/24/2020,Q2,5,C,Lok Ma Chau Spur Line,Departure,0,0,0,0
4/24/2020,Q2,5,C,Hong Kong-Zhuhai-Macao Bridge,Arrival,36,2,0,38
4/24/2020,Q2,5,C,Hong Kong-Zhuhai-Macao Bridge,Departure,13,2,0,15
4/24/2020,Q2,5,C,Lok Ma Chau,Arrival,0,0,0,0
4/24/2020,Q2,5,C,Lok Ma Chau,Departure,0,0,0,0
4/24/2020,Q2,5,C,Man Kam To,Arrival,0,0,0,0
4/24/2020,Q2,5,C,Man Kam To,Departure,0,0,0,0
4/24/2020,Q2,5,C,Sha Tau Kok,Arrival,0,0,0,0
4/24/2020,Q2,5,C,Sha Tau Kok,Departure,0,0,0,0
4/24/2020,Q2,5,C,Shenzhen Bay,Arrival,397,38,0,435
4/24/2020,Q2,5,C,Shenzhen Bay,Departure,214,36,2,252
4/24/2020,Q2,5,C,China Ferry Terminal,Arrival,0,0,0,0
4/24/2020,Q2,5,C,China Ferry Terminal,Departure,0,0,0,0
4/24/2020,Q2,5,C,Harbour Control,Arrival,0,0,0,0
4/24/2020,Q2,5,C,Harbour Control,Departure,0,0,0,0
4/24/2020,Q2,5,C,Kai Tak Cruise Terminal,Arrival,0,0,0,0
4/24/2020,Q2,5,C,Kai Tak Cruise Terminal,Departure,0,0,0,0
4/24/2020,Q2,5,C,Macau Ferry Terminal,Arrival,0,0,0,0
4/24/2020,Q2,5,C,Macau Ferry Terminal,Departure,0,0,0,0
4/24/2020,Q2,5,C,Tuen Mun Ferry Terminal,Arrival,0,0,0,0
4/24/2020,Q2,5,C,Tuen Mun Ferry Terminal,Departure,0,0,0,0
4/25/2020,Q2,5,C,Airport,Arrival,378,7,20,405
4/25/2020,Q2,5,C,Airport,Departure,241,13,41,295
4/25/2020,Q2,5,C,Express Rail Link West Kowloon,Arrival,0,0,0,0
4/25/2020,Q2,5,C,Express Rail Link West Kowloon,Departure,0,0,0,0
4/25/2020,Q2,5,C,Hung Hom,Arrival,0,0,0,0
4/25/2020,Q2,5,C,Hung Hom,Departure,0,0,0,0
4/25/2020,Q2,5,C,Lo Wu,Arrival,0,0,0,0
4/25/2020,Q2,5,C,Lo Wu,Departure,0,0,0,0
4/25/2020,Q2,5,C,Lok Ma Chau Spur Line,Arrival,0,0,0,0
4/25/2020,Q2,5,C,Lok Ma Chau Spur Line,Departure,0,0,0,0
4/25/2020,Q2,5,C,Hong Kong-Zhuhai-Macao Bridge,Arrival,26,1,0,27
4/25/2020,Q2,5,C,Hong Kong-Zhuhai-Macao Bridge,Departure,19,0,0,19
4/25/2020,Q2,5,C,Lok Ma Chau,Arrival,0,0,0,0
4/25/2020,Q2,5,C,Lok Ma Chau,Departure,0,0,0,0
4/25/2020,Q2,5,C,Man Kam To,Arrival,0,0,0,0
4/25/2020,Q2,5,C,Man Kam To,Departure,0,0,0,0
4/25/2020,Q2,5,C,Sha Tau Kok,Arrival,0,0,0,0
4/25/2020,Q2,5,C,Sha Tau Kok,Departure,0,0,0,0
4/25/2020,Q2,5,C,Shenzhen Bay,Arrival,429,67,4,500
4/25/2020,Q2,5,C,Shenzhen Bay,Departure,208,37,0,245
4/25/2020,Q2,5,C,China Ferry Terminal,Arrival,0,0,0,0
4/25/2020,Q2,5,C,China Ferry Terminal,Departure,0,0,0,0
4/25/2020,Q2,5,C,Harbour Control,Arrival,0,0,0,0
4/25/2020,Q2,5,C,Harbour Control,Departure,0,0,0,0
4/25/2020,Q2,5,C,Kai Tak Cruise Terminal,Arrival,0,0,0,0
4/25/2020,Q2,5,C,Kai Tak Cruise Terminal,Departure,0,0,0,0
4/25/2020,Q2,5,C,Macau Ferry Terminal,Arrival,0,0,0,0
4/25/2020,Q2,5,C,Macau Ferry Terminal,Departure,0,0,0,0
4/25/2020,Q2,5,C,Tuen Mun Ferry Terminal,Arrival,0,0,0,0
4/25/2020,Q2,5,C,Tuen Mun Ferry Terminal,Departure,0,0,0,0
4/26/2020,Q2,5,C,Airport,Arrival,421,1,20,442
4/26/2020,Q2,5,C,Airport,Departure,333,18,35,386
4/26/2020,Q2,5,C,Express Rail Link West Kowloon,Arrival,0,0,0,0
4/26/2020,Q2,5,C,Express Rail Link West Kowloon,Departure,0,0,0,0
4/26/2020,Q2,5,C,Hung Hom,Arrival,0,0,0,0
4/26/2020,Q2,5,C,Hung Hom,Departure,0,0,0,0
4/26/2020,Q2,5,C,Lo Wu,Arrival,0,0,0,0
4/26/2020,Q2,5,C,Lo Wu,Departure,0,0,0,0
4/26/2020,Q2,5,C,Lok Ma Chau Spur Line,Arrival,0,0,0,0
4/26/2020,Q2,5,C,Lok Ma Chau Spur Line,Departure,0,0,0,0
4/26/2020,Q2,5,C,Hong Kong-Zhuhai-Macao Bridge,Arrival,21,1,0,22
4/26/2020,Q2,5,C,Hong Kong-Zhuhai-Macao Bridge,Departure,8,1,0,9
4/26/2020,Q2,5,C,Lok Ma Chau,Arrival,0,0,0,0
4/26/2020,Q2,5,C,Lok Ma Chau,Departure,0,0,0,0
4/26/2020,Q2,5,C,Man Kam To,Arrival,0,0,0,0
4/26/2020,Q2,5,C,Man Kam To,Departure,0,0,0,0
4/26/2020,Q2,5,C,Sha Tau Kok,Arrival,0,0,0,0
4/26/2020,Q2,5,C,Sha Tau Kok,Departure,0,0,0,0
4/26/2020,Q2,5,C,Shenzhen Bay,Arrival,407,80,4,491
4/26/2020,Q2,5,C,Shenzhen Bay,Departure,184,59,2,245
4/26/2020,Q2,5,C,China Ferry Terminal,Arrival,0,0,0,0
4/26/2020,Q2,5,C,China Ferry Terminal,Departure,0,0,0,0
4/26/2020,Q2,5,C,Harbour Control,Arrival,0,0,0,0
4/26/2020,Q2,5,C,Harbour Control,Departure,0,0,0,0
4/26/2020,Q2,5,C,Kai Tak Cruise Terminal,Arrival,0,0,0,0
4/26/2020,Q2,5,C,Kai Tak Cruise Terminal,Departure,0,0,0,0
4/26/2020,Q2,5,C,Macau Ferry Terminal,Arrival,0,0,0,0
4/26/2020,Q2,5,C,Macau Ferry Terminal,Departure,0,0,0,0
4/26/2020,Q2,5,C,Tuen Mun Ferry Terminal,Arrival,0,0,0,0
4/26/2020,Q2,5,C,Tuen Mun Ferry Terminal,Departure,0,0,0,0
4/27/2020,Q2,5,C,Airport,Arrival,411,2,10,423
4/27/2020,Q2,5,C,Airport,Departure,125,1,22,148
4/27/2020,Q2,5,C,Express Rail Link West Kowloon,Arrival,0,0,0,0
4/27/2020,Q2,5,C,Express Rail Link West Kowloon,Departure,0,0,0,0
4/27/2020,Q2,5,C,Hung Hom,Arrival,0,0,0,0
4/27/2020,Q2,5,C,Hung Hom,Departure,0,0,0,0
4/27/2020,Q2,5,C,Lo Wu,Arrival,0,0,0,0
4/27/2020,Q2,5,C,Lo Wu,Departure,0,0,0,0
4/27/2020,Q2,5,C,Lok Ma Chau Spur Line,Arrival,0,0,0,0
4/27/2020,Q2,5,C,Lok Ma Chau Spur Line,Departure,0,0,0,0
4/27/2020,Q2,5,C,Hong Kong-Zhuhai-Macao Bridge,Arrival,33,2,1,36
4/27/2020,Q2,5,C,Hong Kong-Zhuhai-Macao Bridge,Departure,36,1,3,40
4/27/2020,Q2,5,C,Lok Ma Chau,Arrival,0,0,0,0
4/27/2020,Q2,5,C,Lok Ma Chau,Departure,0,0,0,0
4/27/2020,Q2,5,C,Man Kam To,Arrival,0,0,0,0
4/27/2020,Q2,5,C,Man Kam To,Departure,0,0,0,0
4/27/2020,Q2,5,C,Sha Tau Kok,Arrival,0,0,0,0
4/27/2020,Q2,5,C,Sha Tau Kok,Departure,0,0,0,0
4/27/2020,Q2,5,C,Shenzhen Bay,Arrival,454,70,1,525
4/27/2020,Q2,5,C,Shenzhen Bay,Departure,577,146,7,730
4/27/2020,Q2,5,C,China Ferry Terminal,Arrival,0,0,0,0
4/27/2020,Q2,5,C,China Ferry Terminal,Departure,0,0,0,0
4/27/2020,Q2,5,C,Harbour Control,Arrival,0,0,0,0
4/27/2020,Q2,5,C,Harbour Control,Departure,0,0,0,0
4/27/2020,Q2,5,C,Kai Tak Cruise Terminal,Arrival,0,0,0,0
4/27/2020,Q2,5,C,Kai Tak Cruise Terminal,Departure,0,0,0,0
4/27/2020,Q2,5,C,Macau Ferry Terminal,Arrival,0,0,0,0
4/27/2020,Q2,5,C,Macau Ferry Terminal,Departure,0,0,0,0
4/27/2020,Q2,5,C,Tuen Mun Ferry Terminal,Arrival,0,0,0,0
4/27/2020,Q2,5,C,Tuen Mun Ferry Terminal,Departure,0,0,0,0
4/28/2020,Q2,5,C,Airport,Arrival,464,0,64,528
4/28/2020,Q2,5,C,Airport,Departure,160,1,50,211
4/28/2020,Q2,5,C,Express Rail Link West Kowloon,Arrival,0,0,0,0
4/28/2020,Q2,5,C,Express Rail Link West Kowloon,Departure,0,0,0,0
4/28/2020,Q2,5,C,Hung Hom,Arrival,0,0,0,0
4/28/2020,Q2,5,C,Hung Hom,Departure,0,0,0,0
4/28/2020,Q2,5,C,Lo Wu,Arrival,0,0,0,0
4/28/2020,Q2,5,C,Lo Wu,Departure,0,0,0,0
4/28/2020,Q2,5,C,Lok Ma Chau Spur Line,Arrival,0,0,0,0
4/28/2020,Q2,5,C,Lok Ma Chau Spur Line,Departure,0,0,0,0
4/28/2020,Q2,5,C,Hong Kong-Zhuhai-Macao Bridge,Arrival,22,2,1,25
4/28/2020,Q2,5,C,Hong Kong-Zhuhai-Macao Bridge,Departure,19,1,3,23
4/28/2020,Q2,5,C,Lok Ma Chau,Arrival,0,0,0,0
4/28/2020,Q2,5,C,Lok Ma Chau,Departure,0,0,0,0
4/28/2020,Q2,5,C,Man Kam To,Arrival,0,0,0,0
4/28/2020,Q2,5,C,Man Kam To,Departure,0,0,0,0
4/28/2020,Q2,5,C,Sha Tau Kok,Arrival,0,0,0,0
4/28/2020,Q2,5,C,Sha Tau Kok,Departure,0,0,0,0
4/28/2020,Q2,5,C,Shenzhen Bay,Arrival,341,49,1,391
4/28/2020,Q2,5,C,Shenzhen Bay,Departure,176,25,3,204
4/28/2020,Q2,5,C,China Ferry Terminal,Arrival,0,0,0,0
4/28/2020,Q2,5,C,China Ferry Terminal,Departure,0,0,0,0
4/28/2020,Q2,5,C,Harbour Control,Arrival,0,0,0,0
4/28/2020,Q2,5,C,Harbour Control,Departure,0,0,0,0
4/28/2020,Q2,5,C,Kai Tak Cruise Terminal,Arrival,0,0,0,0
4/28/2020,Q2,5,C,Kai Tak Cruise Terminal,Departure,0,0,0,0
4/28/2020,Q2,5,C,Macau Ferry Terminal,Arrival,0,0,0,0
4/28/2020,Q2,5,C,Macau Ferry Terminal,Departure,0,0,0,0
4/28/2020,Q2,5,C,Tuen Mun Ferry Terminal,Arrival,0,0,0,0
4/28/2020,Q2,5,C,Tuen Mun Ferry Terminal,Departure,0,0,0,0
4/29/2020,Q2,5,E+F,Airport,Arrival,814,4,15,833
4/29/2020,Q2,5,E+F,Airport,Departure,341,6,44,391
4/29/2020,Q2,5,E+F,Express Rail Link West Kowloon,Arrival,0,0,0,0
4/29/2020,Q2,5,E+F,Express Rail Link West Kowloon,Departure,0,0,0,0
4/29/2020,Q2,5,E+F,Hung Hom,Arrival,0,0,0,0
4/29/2020,Q2,5,E+F,Hung Hom,Departure,0,0,0,0
4/29/2020,Q2,5,E+F,Lo Wu,Arrival,0,0,0,0
4/29/2020,Q2,5,E+F,Lo Wu,Departure,0,0,0,0
4/29/2020,Q2,5,E+F,Lok Ma Chau Spur Line,Arrival,0,0,0,0
4/29/2020,Q2,5,E+F,Lok Ma Chau Spur Line,Departure,0,0,0,0
4/29/2020,Q2,5,E+F,Hong Kong-Zhuhai-Macao Bridge,Arrival,24,2,0,26
4/29/2020,Q2,5,E+F,Hong Kong-Zhuhai-Macao Bridge,Departure,18,1,1,20
4/29/2020,Q2,5,E+F,Lok Ma Chau,Arrival,0,0,0,0
4/29/2020,Q2,5,E+F,Lok Ma Chau,Departure,0,0,0,0
4/29/2020,Q2,5,E+F,Man Kam To,Arrival,0,0,0,0
4/29/2020,Q2,5,E+F,Man Kam To,Departure,0,0,0,0
4/29/2020,Q2,5,E+F,Sha Tau Kok,Arrival,0,0,0,0
4/29/2020,Q2,5,E+F,Sha Tau Kok,Departure,0,0,0,0
4/29/2020,Q2,5,E+F,Shenzhen Bay,Arrival,455,70,2,527
4/29/2020,Q2,5,E+F,Shenzhen Bay,Departure,242,23,5,270
4/29/2020,Q2,5,E+F,China Ferry Terminal,Arrival,0,0,0,0
4/29/2020,Q2,5,E+F,China Ferry Terminal,Departure,0,0,0,0
4/29/2020,Q2,5,E+F,Harbour Control,Arrival,0,0,0,0
4/29/2020,Q2,5,E+F,Harbour Control,Departure,0,0,0,0
4/29/2020,Q2,5,E+F,Kai Tak Cruise Terminal,Arrival,0,0,0,0
4/29/2020,Q2,5,E+F,Kai Tak Cruise Terminal,Departure,0,0,0,0
4/29/2020,Q2,5,E+F,Macau Ferry Terminal,Arrival,0,0,0,0
4/29/2020,Q2,5,E+F,Macau Ferry Terminal,Departure,0,0,0,0
4/29/2020,Q2,5,E+F,Tuen Mun Ferry Terminal,Arrival,0,0,0,0
4/29/2020,Q2,5,E+F,Tuen Mun Ferry Terminal,Departure,0,0,0,0
4/30/2020,Q2,5,E+F,Airport,Arrival,747,5,48,800
4/30/2020,Q2,5,E+F,Airport,Departure,254,17,31,302
4/30/2020,Q2,5,E+F,Express Rail Link West Kowloon,Arrival,0,0,0,0
4/30/2020,Q2,5,E+F,Express Rail Link West Kowloon,Departure,0,0,0,0
4/30/2020,Q2,5,E+F,Hung Hom,Arrival,0,0,0,0
4/30/2020,Q2,5,E+F,Hung Hom,Departure,0,0,0,0
4/30/2020,Q2,5,E+F,Lo Wu,Arrival,0,0,0,0
4/30/2020,Q2,5,E+F,Lo Wu,Departure,0,0,0,0
4/30/2020,Q2,5,E+F,Lok Ma Chau Spur Line,Arrival,0,0,0,0
4/30/2020,Q2,5,E+F,Lok Ma Chau Spur Line,Departure,0,0,0,0
4/30/2020,Q2,5,E+F,Hong Kong-Zhuhai-Macao Bridge,Arrival,37,6,2,45
4/30/2020,Q2,5,E+F,Hong Kong-Zhuhai-Macao Bridge,Departure,31,2,3,36
4/30/2020,Q2,5,E+F,Lok Ma Chau,Arrival,0,0,0,0
4/30/2020,Q2,5,E+F,Lok Ma Chau,Departure,0,0,0,0
4/30/2020,Q2,5,E+F,Man Kam To,Arrival,0,0,0,0
4/30/2020,Q2,5,E+F,Man Kam To,Departure,0,0,0,0
4/30/2020,Q2,5,E+F,Sha Tau Kok,Arrival,0,0,0,0
4/30/2020,Q2,5,E+F,Sha Tau Kok,Departure,0,0,0,0
4/30/2020,Q2,5,E+F,Shenzhen Bay,Arrival,827,114,2,943
4/30/2020,Q2,5,E+F,Shenzhen Bay,Departure,348,70,4,422
4/30/2020,Q2,5,E+F,China Ferry Terminal,Arrival,0,0,0,0
4/30/2020,Q2,5,E+F,China Ferry Terminal,Departure,0,0,0,0
4/30/2020,Q2,5,E+F,Harbour Control,Arrival,0,0,0,0
4/30/2020,Q2,5,E+F,Harbour Control,Departure,0,0,0,0
4/30/2020,Q2,5,E+F,Kai Tak Cruise Terminal,Arrival,0,0,0,0
4/30/2020,Q2,5,E+F,Kai Tak Cruise Terminal,Departure,0,0,0,0
4/30/2020,Q2,5,E+F,Macau Ferry Terminal,Arrival,0,0,0,0
4/30/2020,Q2,5,E+F,Macau Ferry Terminal,Departure,0,0,0,0
4/30/2020,Q2,5,E+F,Tuen Mun Ferry Terminal,Arrival,0,0,0,0
4/30/2020,Q2,5,E+F,Tuen Mun Ferry Terminal,Departure,0,0,0,0
5/1/2020,Q2,5,E+F,Airport,Arrival,837,4,24,865
5/1/2020,Q2,5,E+F,Airport,Departure,533,6,98,637
5/1/2020,Q2,5,E+F,Express Rail Link West Kowloon,Arrival,0,0,0,0
5/1/2020,Q2,5,E+F,Express Rail Link West Kowloon,Departure,0,0,0,0
5/1/2020,Q2,5,E+F,Hung Hom,Arrival,0,0,0,0
5/1/2020,Q2,5,E+F,Hung Hom,Departure,0,0,0,0
5/1/2020,Q2,5,E+F,Lo Wu,Arrival,0,0,0,0
5/1/2020,Q2,5,E+F,Lo Wu,Departure,0,0,0,0
5/1/2020,Q2,5,E+F,Lok Ma Chau Spur Line,Arrival,0,0,0,0
5/1/2020,Q2,5,E+F,Lok Ma Chau Spur Line,Departure,0,0,0,0
5/1/2020,Q2,5,E+F,Hong Kong-Zhuhai-Macao Bridge,Arrival,35,5,1,41
5/1/2020,Q2,5,E+F,Hong Kong-Zhuhai-Macao Bridge,Departure,17,1,1,19
5/1/2020,Q2,5,E+F,Lok Ma Chau,Arrival,0,0,0,0
5/1/2020,Q2,5,E+F,Lok Ma Chau,Departure,0,0,0,0
5/1/2020,Q2,5,E+F,Man Kam To,Arrival,0,0,0,0
5/1/2020,Q2,5,E+F,Man Kam To,Departure,0,0,0,0
5/1/2020,Q2,5,E+F,Sha Tau Kok,Arrival,0,0,0,0
5/1/2020,Q2,5,E+F,Sha Tau Kok,Departure,0,0,0,0
5/1/2020,Q2,5,E+F,Shenzhen Bay,Arrival,507,110,5,622
5/1/2020,Q2,5,E+F,Shenzhen Bay,Departure,265,56,1,322
5/1/2020,Q2,5,E+F,China Ferry Terminal,Arrival,0,0,0,0
5/1/2020,Q2,5,E+F,China Ferry Terminal,Departure,0,0,0,0
5/1/2020,Q2,5,E+F,Harbour Control,Arrival,0,0,0,0
5/1/2020,Q2,5,E+F,Harbour Control,Departure,0,0,0,0
5/1/2020,Q2,5,E+F,Kai Tak Cruise Terminal,Arrival,0,0,0,0
5/1/2020,Q2,5,E+F,Kai Tak Cruise Terminal,Departure,0,0,0,0
5/1/2020,Q2,5,E+F,Macau Ferry Terminal,Arrival,0,0,0,0
5/1/2020,Q2,5,E+F,Macau Ferry Terminal,Departure,0,0,0,0
5/1/2020,Q2,5,E+F,Tuen Mun Ferry Terminal,Arrival,0,0,0,0
5/1/2020,Q2,5,E+F,Tuen Mun Ferry Terminal,Departure,0,0,0,0
5/2/2020,Q2,5,E+F,Airport,Arrival,452,6,39,497
5/2/2020,Q2,5,E+F,Airport,Departure,352,4,72,428
5/2/2020,Q2,5,E+F,Express Rail Link West Kowloon,Arrival,0,0,0,0
5/2/2020,Q2,5,E+F,Express Rail Link West Kowloon,Departure,0,0,0,0
5/2/2020,Q2,5,E+F,Hung Hom,Arrival,0,0,0,0
5/2/2020,Q2,5,E+F,Hung Hom,Departure,0,0,0,0
5/2/2020,Q2,5,E+F,Lo Wu,Arrival,0,0,0,0
5/2/2020,Q2,5,E+F,Lo Wu,Departure,0,0,0,0
5/2/2020,Q2,5,E+F,Lok Ma Chau Spur Line,Arrival,0,0,0,0
5/2/2020,Q2,5,E+F,Lok Ma Chau Spur Line,Departure,0,0,0,0
5/2/2020,Q2,5,E+F,Hong Kong-Zhuhai-Macao Bridge,Arrival,34,5,0,39
5/2/2020,Q2,5,E+F,Hong Kong-Zhuhai-Macao Bridge,Departure,24,0,0,24
5/2/2020,Q2,5,E+F,Lok Ma Chau,Arrival,0,0,0,0
5/2/2020,Q2,5,E+F,Lok Ma Chau,Departure,0,0,0,0
5/2/2020,Q2,5,E+F,Man Kam To,Arrival,0,0,0,0
5/2/2020,Q2,5,E+F,Man Kam To,Departure,0,0,0,0
5/2/2020,Q2,5,E+F,Sha Tau Kok,Arrival,0,0,0,0
5/2/2020,Q2,5,E+F,Sha Tau Kok,Departure,0,0,0,0
5/2/2020,Q2,5,E+F,Shenzhen Bay,Arrival,534,89,0,623
5/2/2020,Q2,5,E+F,Shenzhen Bay,Departure,220,27,3,250
5/2/2020,Q2,5,E+F,China Ferry Terminal,Arrival,0,0,0,0
5/2/2020,Q2,5,E+F,China Ferry Terminal,Departure,0,0,0,0
5/2/2020,Q2,5,E+F,Harbour Control,Arrival,0,0,0,0
5/2/2020,Q2,5,E+F,Harbour Control,Departure,0,0,0,0
5/2/2020,Q2,5,E+F,Kai Tak Cruise Terminal,Arrival,0,0,0,0
5/2/2020,Q2,5,E+F,Kai Tak Cruise Terminal,Departure,0,0,0,0
5/2/2020,Q2,5,E+F,Macau Ferry Terminal,Arrival,0,0,0,0
5/2/2020,Q2,5,E+F,Macau Ferry Terminal,Departure,0,0,0,0
5/2/2020,Q2,5,E+F,Tuen Mun Ferry Terminal,Arrival,0,0,0,0
5/2/2020,Q2,5,E+F,Tuen Mun Ferry Terminal,Departure,0,0,0,0
5/3/2020,Q2,5,E+F,Airport,Arrival,713,1,26,740
5/3/2020,Q2,5,E+F,Airport,Departure,212,6,44,262
5/3/2020,Q2,5,E+F,Express Rail Link West Kowloon,Arrival,0,0,0,0
5/3/2020,Q2,5,E+F,Express Rail Link West Kowloon,Departure,0,0,0,0
5/3/2020,Q2,5,E+F,Hung Hom,Arrival,0,0,0,0
5/3/2020,Q2,5,E+F,Hung Hom,Departure,0,0,0,0
5/3/2020,Q2,5,E+F,Lo Wu,Arrival,0,0,0,0
5/3/2020,Q2,5,E+F,Lo Wu,Departure,0,0,0,0
5/3/2020,Q2,5,E+F,Lok Ma Chau Spur Line,Arrival,0,0,0,0
5/3/2020,Q2,5,E+F,Lok Ma Chau Spur Line,Departure,0,0,0,0
5/3/2020,Q2,5,E+F,Hong Kong-Zhuhai-Macao Bridge,Arrival,38,1,7,46
5/3/2020,Q2,5,E+F,Hong Kong-Zhuhai-Macao Bridge,Departure,10,2,4,16
5/3/2020,Q2,5,E+F,Lok Ma Chau,Arrival,0,0,0,0
5/3/2020,Q2,5,E+F,Lok Ma Chau,Departure,0,0,0,0
5/3/2020,Q2,5,E+F,Man Kam To,Arrival,0,0,0,0
5/3/2020,Q2,5,E+F,Man Kam To,Departure,0,0,0,0
5/3/2020,Q2,5,E+F,Sha Tau Kok,Arrival,0,0,0,0
5/3/2020,Q2,5,E+F,Sha Tau Kok,Departure,0,0,0,0
5/3/2020,Q2,5,E+F,Shenzhen Bay,Arrival,719,140,2,861
5/3/2020,Q2,5,E+F,Shenzhen Bay,Departure,211,40,2,253
5/3/2020,Q2,5,E+F,China Ferry Terminal,Arrival,0,0,0,0
5/3/2020,Q2,5,E+F,China Ferry Terminal,Departure,0,0,0,0
5/3/2020,Q2,5,E+F,Harbour Control,Arrival,0,0,0,0
5/3/2020,Q2,5,E+F,Harbour Control,Departure,0,0,0,0
5/3/2020,Q2,5,E+F,Kai Tak Cruise Terminal,Arrival,0,0,0,0
5/3/2020,Q2,5,E+F,Kai Tak Cruise Terminal,Departure,0,0,0,0
5/3/2020,Q2,5,E+F,Macau Ferry Terminal,Arrival,0,0,0,0
5/3/2020,Q2,5,E+F,Macau Ferry Terminal,Departure,0,0,0,0
5/3/2020,Q2,5,E+F,Tuen Mun Ferry Terminal,Arrival,0,0,0,0
5/3/2020,Q2,5,E+F,Tuen Mun Ferry Terminal,Departure,0,0,0,0
5/4/2020,Q2,5,E+F,Airport,Arrival,770,10,19,799
5/4/2020,Q2,5,E+F,Airport,Departure,251,4,161,416
5/4/2020,Q2,5,E+F,Express Rail Link West Kowloon,Arrival,0,0,0,0
5/4/2020,Q2,5,E+F,Express Rail Link West Kowloon,Departure,0,0,0,0
5/4/2020,Q2,5,E+F,Hung Hom,Arrival,0,0,0,0
5/4/2020,Q2,5,E+F,Hung Hom,Departure,0,0,0,0
5/4/2020,Q2,5,E+F,Lo Wu,Arrival,0,0,0,0
5/4/2020,Q2,5,E+F,Lo Wu,Departure,0,0,0,0
5/4/2020,Q2,5,E+F,Lok Ma Chau Spur Line,Arrival,0,0,0,0
5/4/2020,Q2,5,E+F,Lok Ma Chau Spur Line,Departure,0,0,0,0
5/4/2020,Q2,5,E+F,Hong Kong-Zhuhai-Macao Bridge,Arrival,50,5,11,66
5/4/2020,Q2,5,E+F,Hong Kong-Zhuhai-Macao Bridge,Departure,19,1,0,20
5/4/2020,Q2,5,E+F,Lok Ma Chau,Arrival,0,0,0,0
5/4/2020,Q2,5,E+F,Lok Ma Chau,Departure,0,0,0,0
5/4/2020,Q2,5,E+F,Man Kam To,Arrival,0,0,0,0
5/4/2020,Q2,5,E+F,Man Kam To,Departure,0,0,0,0
5/4/2020,Q2,5,E+F,Sha Tau Kok,Arrival,0,0,0,0
5/4/2020,Q2,5,E+F,Sha Tau Kok,Departure,0,0,0,0
5/4/2020,Q2,5,E+F,Shenzhen Bay,Arrival,629,79,4,712
5/4/2020,Q2,5,E+F,Shenzhen Bay,Departure,288,33,6,327
5/4/2020,Q2,5,E+F,China Ferry Terminal,Arrival,0,0,0,0
5/4/2020,Q2,5,E+F,China Ferry Terminal,Departure,0,0,0,0
5/4/2020,Q2,5,E+F,Harbour Control,Arrival,0,0,0,0
5/4/2020,Q2,5,E+F,Harbour Control,Departure,0,0,0,0
5/4/2020,Q2,5,E+F,Kai Tak Cruise Terminal,Arrival,0,0,0,0
5/4/2020,Q2,5,E+F,Kai Tak Cruise Terminal,Departure,0,0,0,0
5/4/2020,Q2,5,E+F,Macau Ferry Terminal,Arrival,0,0,0,0
5/4/2020,Q2,5,E+F,Macau Ferry Terminal,Departure,0,0,0,0
5/4/2020,Q2,5,E+F,Tuen Mun Ferry Terminal,Arrival,0,0,0,0
5/4/2020,Q2,5,E+F,Tuen Mun Ferry Terminal,Departure,0,0,0,0
5/5/2020,Q2,5,E+F,Airport,Arrival,372,3,11,386
5/5/2020,Q2,5,E+F,Airport,Departure,138,2,24,164
5/5/2020,Q2,5,E+F,Express Rail Link West Kowloon,Arrival,0,0,0,0
5/5/2020,Q2,5,E+F,Express Rail Link West Kowloon,Departure,0,0,0,0
5/5/2020,Q2,5,E+F,Hung Hom,Arrival,0,0,0,0
5/5/2020,Q2,5,E+F,Hung Hom,Departure,0,0,0,0
5/5/2020,Q2,5,E+F,Lo Wu,Arrival,0,0,0,0
5/5/2020,Q2,5,E+F,Lo Wu,Departure,0,0,0,0
5/5/2020,Q2,5,E+F,Lok Ma Chau Spur Line,Arrival,0,0,0,0
5/5/2020,Q2,5,E+F,Lok Ma Chau Spur Line,Departure,0,0,0,0
5/5/2020,Q2,5,E+F,Hong Kong-Zhuhai-Macao Bridge,Arrival,49,6,2,57
5/5/2020,Q2,5,E+F,Hong Kong-Zhuhai-Macao Bridge,Departure,29,0,2,31
5/5/2020,Q2,5,E+F,Lok Ma Chau,Arrival,0,0,0,0
5/5/2020,Q2,5,E+F,Lok Ma Chau,Departure,0,0,0,0
5/5/2020,Q2,5,E+F,Man Kam To,Arrival,0,0,0,0
5/5/2020,Q2,5,E+F,Man Kam To,Departure,0,0,0,0
5/5/2020,Q2,5,E+F,Sha Tau Kok,Arrival,0,0,0,0
5/5/2020,Q2,5,E+F,Sha Tau Kok,Departure,0,0,0,0
5/5/2020,Q2,5,E+F,Shenzhen Bay,Arrival,587,75,1,663
5/5/2020,Q2,5,E+F,Shenzhen Bay,Departure,257,36,12,305
5/5/2020,Q2,5,E+F,China Ferry Terminal,Arrival,0,0,0,0
5/5/2020,Q2,5,E+F,China Ferry Terminal,Departure,0,0,0,0
5/5/2020,Q2,5,E+F,Harbour Control,Arrival,0,0,0,0
5/5/2020,Q2,5,E+F,Harbour Control,Departure,0,0,0,0
5/5/2020,Q2,5,E+F,Kai Tak Cruise Terminal,Arrival,0,0,0,0
5/5/2020,Q2,5,E+F,Kai Tak Cruise Terminal,Departure,0,0,0,0
5/5/2020,Q2,5,E+F,Macau Ferry Terminal,Arrival,0,0,0,0
5/5/2020,Q2,5,E+F,Macau Ferry Terminal,Departure,0,0,0,0
5/5/2020,Q2,5,E+F,Tuen Mun Ferry Terminal,Arrival,0,0,0,0
5/5/2020,Q2,5,E+F,Tuen Mun Ferry Terminal,Departure,0,0,0,0
5/6/2020,Q2,5,E+F,Airport,Arrival,496,4,13,513
5/6/2020,Q2,5,E+F,Airport,Departure,313,9,30,352
5/6/2020,Q2,5,E+F,Express Rail Link West Kowloon,Arrival,0,0,0,0
5/6/2020,Q2,5,E+F,Express Rail Link West Kowloon,Departure,0,0,0,0
5/6/2020,Q2,5,E+F,Hung Hom,Arrival,0,0,0,0
5/6/2020,Q2,5,E+F,Hung Hom,Departure,0,0,0,0
5/6/2020,Q2,5,E+F,Lo Wu,Arrival,0,0,0,0
5/6/2020,Q2,5,E+F,Lo Wu,Departure,0,0,0,0
5/6/2020,Q2,5,E+F,Lok Ma Chau Spur Line,Arrival,0,0,0,0
5/6/2020,Q2,5,E+F,Lok Ma Chau Spur Line,Departure,0,0,0,0
5/6/2020,Q2,5,E+F,Hong Kong-Zhuhai-Macao Bridge,Arrival,53,4,6,63
5/6/2020,Q2,5,E+F,Hong Kong-Zhuhai-Macao Bridge,Departure,13,2,3,18
5/6/2020,Q2,5,E+F,Lok Ma Chau,Arrival,0,0,0,0
5/6/2020,Q2,5,E+F,Lok Ma Chau,Departure,0,0,0,0
5/6/2020,Q2,5,E+F,Man Kam To,Arrival,0,0,0,0
5/6/2020,Q2,5,E+F,Man Kam To,Departure,0,0,0,0
5/6/2020,Q2,5,E+F,Sha Tau Kok,Arrival,0,0,0,0
5/6/2020,Q2,5,E+F,Sha Tau Kok,Departure,0,0,0,0
5/6/2020,Q2,5,E+F,Shenzhen Bay,Arrival,754,79,1,834
5/6/2020,Q2,5,E+F,Shenzhen Bay,Departure,287,43,7,337
5/6/2020,Q2,5,E+F,China Ferry Terminal,Arrival,0,0,0,0
5/6/2020,Q2,5,E+F,China Ferry Terminal,Departure,0,0,0,0
5/6/2020,Q2,5,E+F,Harbour Control,Arrival,0,0,0,0
5/6/2020,Q2,5,E+F,Harbour Control,Departure,0,0,0,0
5/6/2020,Q2,5,E+F,Kai Tak Cruise Terminal,Arrival,0,0,0,0
5/6/2020,Q2,5,E+F,Kai Tak Cruise Terminal,Departure,0,0,0,0
5/6/2020,Q2,5,E+F,Macau Ferry Terminal,Arrival,0,0,0,0
5/6/2020,Q2,5,E+F,Macau Ferry Terminal,Departure,0,0,0,0
5/6/2020,Q2,5,E+F,Tuen Mun Ferry Terminal,Arrival,0,0,0,0
5/6/2020,Q2,5,E+F,Tuen Mun Ferry Terminal,Departure,0,0,0,0
5/7/2020,Q2,5,E+F,Airport,Arrival,301,5,5,311
5/7/2020,Q2,5,E+F,Airport,Departure,143,3,8,154
5/7/2020,Q2,5,E+F,Express Rail Link West Kowloon,Arrival,0,0,0,0
5/7/2020,Q2,5,E+F,Express Rail Link West Kowloon,Departure,0,0,0,0
5/7/2020,Q2,5,E+F,Hung Hom,Arrival,0,0,0,0
5/7/2020,Q2,5,E+F,Hung Hom,Departure,0,0,0,0
5/7/2020,Q2,5,E+F,Lo Wu,Arrival,0,0,0,0
5/7/2020,Q2,5,E+F,Lo Wu,Departure,0,0,0,0
5/7/2020,Q2,5,E+F,Lok Ma Chau Spur Line,Arrival,0,0,0,0
5/7/2020,Q2,5,E+F,Lok Ma Chau Spur Line,Departure,0,0,0,0
5/7/2020,Q2,5,E+F,Hong Kong-Zhuhai-Macao Bridge,Arrival,52,0,2,54
5/7/2020,Q2,5,E+F,Hong Kong-Zhuhai-Macao Bridge,Departure,21,3,0,24
5/7/2020,Q2,5,E+F,Lok Ma Chau,Arrival,0,0,0,0
5/7/2020,Q2,5,E+F,Lok Ma Chau,Departure,0,0,0,0
5/7/2020,Q2,5,E+F,Man Kam To,Arrival,0,0,0,0
5/7/2020,Q2,5,E+F,Man Kam To,Departure,0,0,0,0
5/7/2020,Q2,5,E+F,Sha Tau Kok,Arrival,0,0,0,0
5/7/2020,Q2,5,E+F,Sha Tau Kok,Departure,0,0,0,0
5/7/2020,Q2,5,E+F,Shenzhen Bay,Arrival,761,103,2,866
5/7/2020,Q2,5,E+F,Shenzhen Bay,Departure,298,69,0,367
5/7/2020,Q2,5,E+F,China Ferry Terminal,Arrival,0,0,0,0
5/7/2020,Q2,5,E+F,China Ferry Terminal,Departure,0,0,0,0
5/7/2020,Q2,5,E+F,Harbour Control,Arrival,0,0,0,0
5/7/2020,Q2,5,E+F,Harbour Control,Departure,0,0,0,0
5/7/2020,Q2,5,E+F,Kai Tak Cruise Terminal,Arrival,0,0,0,0
5/7/2020,Q2,5,E+F,Kai Tak Cruise Terminal,Departure,0,0,0,0
5/7/2020,Q2,5,E+F,Macau Ferry Terminal,Arrival,0,0,0,0
5/7/2020,Q2,5,E+F,Macau Ferry Terminal,Departure,0,0,0,0
5/7/2020,Q2,5,E+F,Tuen Mun Ferry Terminal,Arrival,0,0,0,0
5/7/2020,Q2,5,E+F,Tuen Mun Ferry Terminal,Departure,0,0,0,0
5/8/2020,Q2,5,E+F,Airport,Arrival,1249,13,35,1297
5/8/2020,Q2,5,E+F,Airport,Departure,371,9,49,429
5/8/2020,Q2,5,E+F,Express Rail Link West Kowloon,Arrival,0,0,0,0
5/8/2020,Q2,5,E+F,Express Rail Link West Kowloon,Departure,0,0,0,0
5/8/2020,Q2,5,E+F,Hung Hom,Arrival,0,0,0,0
5/8/2020,Q2,5,E+F,Hung Hom,Departure,0,0,0,0
5/8/2020,Q2,5,E+F,Lo Wu,Arrival,0,0,0,0
5/8/2020,Q2,5,E+F,Lo Wu,Departure,0,0,0,0
5/8/2020,Q2,5,E+F,Lok Ma Chau Spur Line,Arrival,0,0,0,0
5/8/2020,Q2,5,E+F,Lok Ma Chau Spur Line,Departure,0,0,0,0
5/8/2020,Q2,5,E+F,Hong Kong-Zhuhai-Macao Bridge,Arrival,153,7,9,169
5/8/2020,Q2,5,E+F,Hong Kong-Zhuhai-Macao Bridge,Departure,46,1,6,53
5/8/2020,Q2,5,E+F,Lok Ma Chau,Arrival,0,0,0,0
5/8/2020,Q2,5,E+F,Lok Ma Chau,Departure,0,0,0,0
5/8/2020,Q2,5,E+F,Man Kam To,Arrival,0,0,0,0
5/8/2020,Q2,5,E+F,Man Kam To,Departure,0,0,0,0
5/8/2020,Q2,5,E+F,Sha Tau Kok,Arrival,0,0,0,0
5/8/2020,Q2,5,E+F,Sha Tau Kok,Departure,0,0,0,0
5/8/2020,Q2,5,E+F,Shenzhen Bay,Arrival,1045,137,4,1186
5/8/2020,Q2,5,E+F,Shenzhen Bay,Departure,348,67,2,417
5/8/2020,Q2,5,E+F,China Ferry Terminal,Arrival,0,0,0,0
5/8/2020,Q2,5,E+F,China Ferry Terminal,Departure,0,0,0,0
5/8/2020,Q2,5,E+F,Harbour Control,Arrival,0,0,0,0
5/8/2020,Q2,5,E+F,Harbour Control,Departure,0,0,0,0
5/8/2020,Q2,5,E+F,Kai Tak Cruise Terminal,Arrival,0,0,0,0
5/8/2020,Q2,5,E+F,Kai Tak Cruise Terminal,Departure,0,0,0,0
5/8/2020,Q2,5,E+F,Macau Ferry Terminal,Arrival,0,0,0,0
5/8/2020,Q2,5,E+F,Macau Ferry Terminal,Departure,0,0,0,0
5/8/2020,Q2,5,E+F,Tuen Mun Ferry Terminal,Arrival,0,0,0,0
5/8/2020,Q2,5,E+F,Tuen Mun Ferry Terminal,Departure,0,0,0,0
5/9/2020,Q2,5,E+F,Airport,Arrival,560,6,63,629
5/9/2020,Q2,5,E+F,Airport,Departure,260,14,28,302
5/9/2020,Q2,5,E+F,Express Rail Link West Kowloon,Arrival,0,0,0,0
5/9/2020,Q2,5,E+F,Express Rail Link West Kowloon,Departure,0,0,0,0
5/9/2020,Q2,5,E+F,Hung Hom,Arrival,0,0,0,0
5/9/2020,Q2,5,E+F,Hung Hom,Departure,0,0,0,0
5/9/2020,Q2,5,E+F,Lo Wu,Arrival,0,0,0,0
5/9/2020,Q2,5,E+F,Lo Wu,Departure,0,0,0,0
5/9/2020,Q2,5,E+F,Lok Ma Chau Spur Line,Arrival,0,0,0,0
5/9/2020,Q2,5,E+F,Lok Ma Chau Spur Line,Departure,0,0,0,0
5/9/2020,Q2,5,E+F,Hong Kong-Zhuhai-Macao Bridge,Arrival,144,7,4,155
5/9/2020,Q2,5,E+F,Hong Kong-Zhuhai-Macao Bridge,Departure,43,5,1,49
5/9/2020,Q2,5,E+F,Lok Ma Chau,Arrival,0,0,0,0
5/9/2020,Q2,5,E+F,Lok Ma Chau,Departure,0,0,0,0
5/9/2020,Q2,5,E+F,Man Kam To,Arrival,0,0,0,0
5/9/2020,Q2,5,E+F,Man Kam To,Departure,0,0,0,0
5/9/2020,Q2,5,E+F,Sha Tau Kok,Arrival,0,0,0,0
5/9/2020,Q2,5,E+F,Sha Tau Kok,Departure,0,0,0,0
5/9/2020,Q2,5,E+F,Shenzhen Bay,Arrival,1056,156,5,1217
5/9/2020,Q2,5,E+F,Shenzhen Bay,Departure,237,38,3,278
5/9/2020,Q2,5,E+F,China Ferry Terminal,Arrival,0,0,0,0
5/9/2020,Q2,5,E+F,China Ferry Terminal,Departure,0,0,0,0
5/9/2020,Q2,5,E+F,Harbour Control,Arrival,0,0,0,0
5/9/2020,Q2,5,E+F,Harbour Control,Departure,0,0,0,0
5/9/2020,Q2,5,E+F,Kai Tak Cruise Terminal,Arrival,0,0,0,0
5/9/2020,Q2,5,E+F,Kai Tak Cruise Terminal,Departure,0,0,0,0
5/9/2020,Q2,5,E+F,Macau Ferry Terminal,Arrival,0,0,0,0
5/9/2020,Q2,5,E+F,Macau Ferry Terminal,Departure,0,0,0,0
5/9/2020,Q2,5,E+F,Tuen Mun Ferry Terminal,Arrival,0,0,0,0
5/9/2020,Q2,5,E+F,Tuen Mun Ferry Terminal,Departure,0,0,0,0
5/10/2020,Q2,5,E+F,Airport,Arrival,923,7,41,971
5/10/2020,Q2,5,E+F,Airport,Departure,254,7,42,303
5/10/2020,Q2,5,E+F,Express Rail Link West Kowloon,Arrival,0,0,0,0
5/10/2020,Q2,5,E+F,Express Rail Link West Kowloon,Departure,0,0,0,0
5/10/2020,Q2,5,E+F,Hung Hom,Arrival,0,0,0,0
5/10/2020,Q2,5,E+F,Hung Hom,Departure,0,0,0,0
5/10/2020,Q2,5,E+F,Lo Wu,Arrival,0,0,0,0
5/10/2020,Q2,5,E+F,Lo Wu,Departure,0,0,0,0
5/10/2020,Q2,5,E+F,Lok Ma Chau Spur Line,Arrival,0,0,0,0
5/10/2020,Q2,5,E+F,Lok Ma Chau Spur Line,Departure,0,0,0,0
5/10/2020,Q2,5,E+F,Hong Kong-Zhuhai-Macao Bridge,Arrival,126,6,5,137
5/10/2020,Q2,5,E+F,Hong Kong-Zhuhai-Macao Bridge,Departure,33,1,3,37
5/10/2020,Q2,5,E+F,Lok Ma Chau,Arrival,0,0,0,0
5/10/2020,Q2,5,E+F,Lok Ma Chau,Departure,0,0,0,0
5/10/2020,Q2,5,E+F,Man Kam To,Arrival,0,0,0,0
5/10/2020,Q2,5,E+F,Man Kam To,Departure,0,0,0,0
5/10/2020,Q2,5,E+F,Sha Tau Kok,Arrival,0,0,0,0
5/10/2020,Q2,5,E+F,Sha Tau Kok,Departure,0,0,0,0
5/10/2020,Q2,5,E+F,Shenzhen Bay,Arrival,1783,201,4,1988
5/10/2020,Q2,5,E+F,Shenzhen Bay,Departure,233,43,5,281
5/10/2020,Q2,5,E+F,China Ferry Terminal,Arrival,0,0,0,0
5/10/2020,Q2,5,E+F,China Ferry Terminal,Departure,0,0,0,0
5/10/2020,Q2,5,E+F,Harbour Control,Arrival,0,0,0,0
5/10/2020,Q2,5,E+F,Harbour Control,Departure,0,0,0,0
5/10/2020,Q2,5,E+F,Kai Tak Cruise Terminal,Arrival,0,0,0,0
5/10/2020,Q2,5,E+F,Kai Tak Cruise Terminal,Departure,0,0,0,0
5/10/2020,Q2,5,E+F,Macau Ferry Terminal,Arrival,0,0,0,0
5/10/2020,Q2,5,E+F,Macau Ferry Terminal,Departure,0,0,0,0
5/10/2020,Q2,5,E+F,Tuen Mun Ferry Terminal,Arrival,0,0,0,0
5/10/2020,Q2,5,E+F,Tuen Mun Ferry Terminal,Departure,0,0,0,0
5/11/2020,Q2,5,E+F,Airport,Arrival,797,7,30,834
5/11/2020,Q2,5,E+F,Airport,Departure,195,8,25,228
5/11/2020,Q2,5,E+F,Express Rail Link West Kowloon,Arrival,0,0,0,0
5/11/2020,Q2,5,E+F,Express Rail Link West Kowloon,Departure,0,0,0,0
5/11/2020,Q2,5,E+F,Hung Hom,Arrival,0,0,0,0
5/11/2020,Q2,5,E+F,Hung Hom,Departure,0,0,0,0
5/11/2020,Q2,5,E+F,Lo Wu,Arrival,0,0,0,0
5/11/2020,Q2,5,E+F,Lo Wu,Departure,0,0,0,0
5/11/2020,Q2,5,E+F,Lok Ma Chau Spur Line,Arrival,0,0,0,0
5/11/2020,Q2,5,E+F,Lok Ma Chau Spur Line,Departure,0,0,0,0
5/11/2020,Q2,5,E+F,Hong Kong-Zhuhai-Macao Bridge,Arrival,167,3,7,177
5/11/2020,Q2,5,E+F,Hong Kong-Zhuhai-Macao Bridge,Departure,34,3,5,42
5/11/2020,Q2,5,E+F,Lok Ma Chau,Arrival,0,0,0,0
5/11/2020,Q2,5,E+F,Lok Ma Chau,Departure,0,0,0,0
5/11/2020,Q2,5,E+F,Man Kam To,Arrival,0,0,0,0
5/11/2020,Q2,5,E+F,Man Kam To,Departure,0,0,0,0
5/11/2020,Q2,5,E+F,Sha Tau Kok,Arrival,0,0,0,0
5/11/2020,Q2,5,E+F,Sha Tau Kok,Departure,0,0,0,0
5/11/2020,Q2,5,E+F,Shenzhen Bay,Arrival,1886,175,6,2067
5/11/2020,Q2,5,E+F,Shenzhen Bay,Departure,454,52,2,508
5/11/2020,Q2,5,E+F,China Ferry Terminal,Arrival,0,0,0,0
5/11/2020,Q2,5,E+F,China Ferry Terminal,Departure,0,0,0,0
5/11/2020,Q2,5,E+F,Harbour Control,Arrival,0,0,0,0
5/11/2020,Q2,5,E+F,Harbour Control,Departure,0,0,0,0
5/11/2020,Q2,5,E+F,Kai Tak Cruise Terminal,Arrival,0,0,0,0
5/11/2020,Q2,5,E+F,Kai Tak Cruise Terminal,Departure,0,0,0,0
5/11/2020,Q2,5,E+F,Macau Ferry Terminal,Arrival,0,0,0,0
5/11/2020,Q2,5,E+F,Macau Ferry Terminal,Departure,0,0,0,0
5/11/2020,Q2,5,E+F,Tuen Mun Ferry Terminal,Arrival,0,0,0,0
5/11/2020,Q2,5,E+F,Tuen Mun Ferry Terminal,Departure,0,0,0,0
5/12/2020,Q2,5,E+F,Airport,Arrival,452,5,33,490
5/12/2020,Q2,5,E+F,Airport,Departure,146,7,34,187
5/12/2020,Q2,5,E+F,Express Rail Link West Kowloon,Arrival,0,0,0,0
5/12/2020,Q2,5,E+F,Express Rail Link West Kowloon,Departure,0,0,0,0
5/12/2020,Q2,5,E+F,Hung Hom,Arrival,0,0,0,0
5/12/2020,Q2,5,E+F,Hung Hom,Departure,0,0,0,0
5/12/2020,Q2,5,E+F,Lo Wu,Arrival,0,0,0,0
5/12/2020,Q2,5,E+F,Lo Wu,Departure,0,0,0,0
5/12/2020,Q2,5,E+F,Lok Ma Chau Spur Line,Arrival,0,0,0,0
5/12/2020,Q2,5,E+F,Lok Ma Chau Spur Line,Departure,0,0,0,0
5/12/2020,Q2,5,E+F,Hong Kong-Zhuhai-Macao Bridge,Arrival,180,6,6,192
5/12/2020,Q2,5,E+F,Hong Kong-Zhuhai-Macao Bridge,Departure,28,0,0,28
5/12/2020,Q2,5,E+F,Lok Ma Chau,Arrival,0,0,0,0
5/12/2020,Q2,5,E+F,Lok Ma Chau,Departure,0,0,0,0
5/12/2020,Q2,5,E+F,Man Kam To,Arrival,0,0,0,0
5/12/2020,Q2,5,E+F,Man Kam To,Departure,0,0,0,0
5/12/2020,Q2,5,E+F,Sha Tau Kok,Arrival,0,0,0,0
5/12/2020,Q2,5,E+F,Sha Tau Kok,Departure,0,0,0,0
5/12/2020,Q2,5,E+F,Shenzhen Bay,Arrival,1906,184,6,2096
5/12/2020,Q2,5,E+F,Shenzhen Bay,Departure,278,36,9,323
5/12/2020,Q2,5,E+F,China Ferry Terminal,Arrival,0,0,0,0
5/12/2020,Q2,5,E+F,China Ferry Terminal,Departure,0,0,0,0
5/12/2020,Q2,5,E+F,Harbour Control,Arrival,0,0,0,0
5/12/2020,Q2,5,E+F,Harbour Control,Departure,0,0,0,0
5/12/2020,Q2,5,E+F,Kai Tak Cruise Terminal,Arrival,0,0,0,0
5/12/2020,Q2,5,E+F,Kai Tak Cruise Terminal,Departure,0,0,0,0
5/12/2020,Q2,5,E+F,Macau Ferry Terminal,Arrival,0,0,0,0
5/12/2020,Q2,5,E+F,Macau Ferry Terminal,Departure,0,0,0,0
5/12/2020,Q2,5,E+F,Tuen Mun Ferry Terminal,Arrival,0,0,0,0
5/12/2020,Q2,5,E+F,Tuen Mun Ferry Terminal,Departure,0,0,0,0
5/13/2020,Q2,5,E+F,Airport,Arrival,600,13,24,637
5/13/2020,Q2,5,E+F,Airport,Departure,368,10,77,455
5/13/2020,Q2,5,E+F,Express Rail Link West Kowloon,Arrival,0,0,0,0
5/13/2020,Q2,5,E+F,Express Rail Link West Kowloon,Departure,0,0,0,0
5/13/2020,Q2,5,E+F,Hung Hom,Arrival,0,0,0,0
5/13/2020,Q2,5,E+F,Hung Hom,Departure,0,0,0,0
5/13/2020,Q2,5,E+F,Lo Wu,Arrival,0,0,0,0
5/13/2020,Q2,5,E+F,Lo Wu,Departure,0,0,0,0
5/13/2020,Q2,5,E+F,Lok Ma Chau Spur Line,Arrival,0,0,0,0
5/13/2020,Q2,5,E+F,Lok Ma Chau Spur Line,Departure,0,0,0,0
5/13/2020,Q2,5,E+F,Hong Kong-Zhuhai-Macao Bridge,Arrival,118,5,1,124
5/13/2020,Q2,5,E+F,Hong Kong-Zhuhai-Macao Bridge,Departure,35,0,4,39
5/13/2020,Q2,5,E+F,Lok Ma Chau,Arrival,0,0,0,0
5/13/2020,Q2,5,E+F,Lok Ma Chau,Departure,0,0,0,0
5/13/2020,Q2,5,E+F,Man Kam To,Arrival,0,0,0,0
5/13/2020,Q2,5,E+F,Man Kam To,Departure,0,0,0,0
5/13/2020,Q2,5,E+F,Sha Tau Kok,Arrival,0,0,0,0
5/13/2020,Q2,5,E+F,Sha Tau Kok,Departure,0,0,0,0
5/13/2020,Q2,5,E+F,Shenzhen Bay,Arrival,1149,112,8,1269
5/13/2020,Q2,5,E+F,Shenzhen Bay,Departure,265,66,1,332
5/13/2020,Q2,5,E+F,China Ferry Terminal,Arrival,0,0,0,0
5/13/2020,Q2,5,E+F,China Ferry Terminal,Departure,0,0,0,0
5/13/2020,Q2,5,E+F,Harbour Control,Arrival,0,0,0,0
5/13/2020,Q2,5,E+F,Harbour Control,Departure,0,0,0,0
5/13/2020,Q2,5,E+F,Kai Tak Cruise Terminal,Arrival,0,0,0,0
5/13/2020,Q2,5,E+F,Kai Tak Cruise Terminal,Departure,0,0,0,0
5/13/2020,Q2,5,E+F,Macau Ferry Terminal,Arrival,0,0,0,0
5/13/2020,Q2,5,E+F,Macau Ferry Terminal,Departure,0,0,0,0
5/13/2020,Q2,5,E+F,Tuen Mun Ferry Terminal,Arrival,0,0,0,0
5/13/2020,Q2,5,E+F,Tuen Mun Ferry Terminal,Departure,0,0,0,0
5/14/2020,Q2,5,E+F,Airport,Arrival,597,3,32,632
5/14/2020,Q2,5,E+F,Airport,Departure,187,2,41,230
5/14/2020,Q2,5,E+F,Express Rail Link West Kowloon,Arrival,0,0,0,0
5/14/2020,Q2,5,E+F,Express Rail Link West Kowloon,Departure,0,0,0,0
5/14/2020,Q2,5,E+F,Hung Hom,Arrival,0,0,0,0
5/14/2020,Q2,5,E+F,Hung Hom,Departure,0,0,0,0
5/14/2020,Q2,5,E+F,Lo Wu,Arrival,0,0,0,0
5/14/2020,Q2,5,E+F,Lo Wu,Departure,0,0,0,0
5/14/2020,Q2,5,E+F,Lok Ma Chau Spur Line,Arrival,0,0,0,0
5/14/2020,Q2,5,E+F,Lok Ma Chau Spur Line,Departure,0,0,0,0
5/14/2020,Q2,5,E+F,Hong Kong-Zhuhai-Macao Bridge,Arrival,119,5,11,135
5/14/2020,Q2,5,E+F,Hong Kong-Zhuhai-Macao Bridge,Departure,41,0,5,46
5/14/2020,Q2,5,E+F,Lok Ma Chau,Arrival,0,0,0,0
5/14/2020,Q2,5,E+F,Lok Ma Chau,Departure,0,0,0,0
5/14/2020,Q2,5,E+F,Man Kam To,Arrival,0,0,0,0
5/14/2020,Q2,5,E+F,Man Kam To,Departure,0,0,0,0
5/14/2020,Q2,5,E+F,Sha Tau Kok,Arrival,0,0,0,0
5/14/2020,Q2,5,E+F,Sha Tau Kok,Departure,0,0,0,0
5/14/2020,Q2,5,E+F,Shenzhen Bay,Arrival,777,122,4,903
5/14/2020,Q2,5,E+F,Shenzhen Bay,Departure,298,41,29,368
5/14/2020,Q2,5,E+F,China Ferry Terminal,Arrival,0,0,0,0
5/14/2020,Q2,5,E+F,China Ferry Terminal,Departure,0,0,0,0
5/14/2020,Q2,5,E+F,Harbour Control,Arrival,0,0,0,0
5/14/2020,Q2,5,E+F,Harbour Control,Departure,0,0,0,0
5/14/2020,Q2,5,E+F,Kai Tak Cruise Terminal,Arrival,0,0,0,0
5/14/2020,Q2,5,E+F,Kai Tak Cruise Terminal,Departure,0,0,0,0
5/14/2020,Q2,5,E+F,Macau Ferry Terminal,Arrival,0,0,0,0
5/14/2020,Q2,5,E+F,Macau Ferry Terminal,Departure,0,0,0,0
5/14/2020,Q2,5,E+F,Tuen Mun Ferry Terminal,Arrival,0,0,0,0
5/14/2020,Q2,5,E+F,Tuen Mun Ferry Terminal,Departure,0,0,0,0
5/15/2020,Q2,5,E+F,Airport,Arrival,939,3,31,973
5/15/2020,Q2,5,E+F,Airport,Departure,251,3,60,314
5/15/2020,Q2,5,E+F,Express Rail Link West Kowloon,Arrival,0,0,0,0
5/15/2020,Q2,5,E+F,Express Rail Link West Kowloon,Departure,0,0,0,0
5/15/2020,Q2,5,E+F,Hung Hom,Arrival,0,0,0,0
5/15/2020,Q2,5,E+F,Hung Hom,Departure,0,0,0,0
5/15/2020,Q2,5,E+F,Lo Wu,Arrival,0,0,0,0
5/15/2020,Q2,5,E+F,Lo Wu,Departure,0,0,0,0
5/15/2020,Q2,5,E+F,Lok Ma Chau Spur Line,Arrival,0,0,0,0
5/15/2020,Q2,5,E+F,Lok Ma Chau Spur Line,Departure,0,0,0,0
5/15/2020,Q2,5,E+F,Hong Kong-Zhuhai-Macao Bridge,Arrival,102,9,8,119
5/15/2020,Q2,5,E+F,Hong Kong-Zhuhai-Macao Bridge,Departure,51,5,9,65
5/15/2020,Q2,5,E+F,Lok Ma Chau,Arrival,0,0,0,0
5/15/2020,Q2,5,E+F,Lok Ma Chau,Departure,0,0,0,0
5/15/2020,Q2,5,E+F,Man Kam To,Arrival,0,0,0,0
5/15/2020,Q2,5,E+F,Man Kam To,Departure,0,0,0,0
5/15/2020,Q2,5,E+F,Sha Tau Kok,Arrival,0,0,0,0
5/15/2020,Q2,5,E+F,Sha Tau Kok,Departure,0,0,0,0
5/15/2020,Q2,5,E+F,Shenzhen Bay,Arrival,885,133,5,1023
5/15/2020,Q2,5,E+F,Shenzhen Bay,Departure,293,55,1,349
5/15/2020,Q2,5,E+F,China Ferry Terminal,Arrival,0,0,0,0
5/15/2020,Q2,5,E+F,China Ferry Terminal,Departure,0,0,0,0
5/15/2020,Q2,5,E+F,Harbour Control,Arrival,0,0,0,0
5/15/2020,Q2,5,E+F,Harbour Control,Departure,0,0,0,0
5/15/2020,Q2,5,E+F,Kai Tak Cruise Terminal,Arrival,0,0,0,0
5/15/2020,Q2,5,E+F,Kai Tak Cruise Terminal,Departure,0,0,0,0
5/15/2020,Q2,5,E+F,Macau Ferry Terminal,Arrival,0,0,0,0
5/15/2020,Q2,5,E+F,Macau Ferry Terminal,Departure,0,0,0,0
5/15/2020,Q2,5,E+F,Tuen Mun Ferry Terminal,Arrival,0,0,0,0
5/15/2020,Q2,5,E+F,Tuen Mun Ferry Terminal,Departure,0,0,0,0
5/16/2020,Q2,5,E+F,Airport,Arrival,891,13,149,1053
5/16/2020,Q2,5,E+F,Airport,Departure,337,5,77,419
5/16/2020,Q2,5,E+F,Express Rail Link West Kowloon,Arrival,0,0,0,0
5/16/2020,Q2,5,E+F,Express Rail Link West Kowloon,Departure,0,0,0,0
5/16/2020,Q2,5,E+F,Hung Hom,Arrival,0,0,0,0
5/16/2020,Q2,5,E+F,Hung Hom,Departure,0,0,0,0
5/16/2020,Q2,5,E+F,Lo Wu,Arrival,0,0,0,0
5/16/2020,Q2,5,E+F,Lo Wu,Departure,0,0,0,0
5/16/2020,Q2,5,E+F,Lok Ma Chau Spur Line,Arrival,0,0,0,0
5/16/2020,Q2,5,E+F,Lok Ma Chau Spur Line,Departure,0,0,0,0
5/16/2020,Q2,5,E+F,Hong Kong-Zhuhai-Macao Bridge,Arrival,80,6,7,93
5/16/2020,Q2,5,E+F,Hong Kong-Zhuhai-Macao Bridge,Departure,46,3,3,52
5/16/2020,Q2,5,E+F,Lok Ma Chau,Arrival,0,0,0,0
5/16/2020,Q2,5,E+F,Lok Ma Chau,Departure,0,0,0,0
5/16/2020,Q2,5,E+F,Man Kam To,Arrival,0,0,0,0
5/16/2020,Q2,5,E+F,Man Kam To,Departure,0,0,0,0
5/16/2020,Q2,5,E+F,Sha Tau Kok,Arrival,0,0,0,0
5/16/2020,Q2,5,E+F,Sha Tau Kok,Departure,0,0,0,0
5/16/2020,Q2,5,E+F,Shenzhen Bay,Arrival,950,155,9,1114
5/16/2020,Q2,5,E+F,Shenzhen Bay,Departure,311,45,3,359
5/16/2020,Q2,5,E+F,China Ferry Terminal,Arrival,0,0,0,0
5/16/2020,Q2,5,E+F,China Ferry Terminal,Departure,0,0,0,0
5/16/2020,Q2,5,E+F,Harbour Control,Arrival,0,0,0,0
5/16/2020,Q2,5,E+F,Harbour Control,Departure,0,0,0,0
5/16/2020,Q2,5,E+F,Kai Tak Cruise Terminal,Arrival,0,0,0,0
5/16/2020,Q2,5,E+F,Kai Tak Cruise Terminal,Departure,0,0,0,0
5/16/2020,Q2,5,E+F,Macau Ferry Terminal,Arrival,0,0,0,0
5/16/2020,Q2,5,E+F,Macau Ferry Terminal,Departure,0,0,0,0
5/16/2020,Q2,5,E+F,Tuen Mun Ferry Terminal,Arrival,0,0,0,0
5/16/2020,Q2,5,E+F,Tuen Mun Ferry Terminal,Departure,0,0,0,0
5/17/2020,Q2,5,E+F,Airport,Arrival,873,6,55,934
5/17/2020,Q2,5,E+F,Airport,Departure,221,7,61,289
5/17/2020,Q2,5,E+F,Express Rail Link West Kowloon,Arrival,0,0,0,0
5/17/2020,Q2,5,E+F,Express Rail Link West Kowloon,Departure,0,0,0,0
5/17/2020,Q2,5,E+F,Hung Hom,Arrival,0,0,0,0
5/17/2020,Q2,5,E+F,Hung Hom,Departure,0,0,0,0
5/17/2020,Q2,5,E+F,Lo Wu,Arrival,0,0,0,0
5/17/2020,Q2,5,E+F,Lo Wu,Departure,0,0,0,0
5/17/2020,Q2,5,E+F,Lok Ma Chau Spur Line,Arrival,0,0,0,0
5/17/2020,Q2,5,E+F,Lok Ma Chau Spur Line,Departure,0,0,0,0
5/17/2020,Q2,5,E+F,Hong Kong-Zhuhai-Macao Bridge,Arrival,110,5,3,118
5/17/2020,Q2,5,E+F,Hong Kong-Zhuhai-Macao Bridge,Departure,30,4,1,35
5/17/2020,Q2,5,E+F,Lok Ma Chau,Arrival,0,0,0,0
5/17/2020,Q2,5,E+F,Lok Ma Chau,Departure,0,0,0,0
5/17/2020,Q2,5,E+F,Man Kam To,Arrival,0,0,0,0
5/17/2020,Q2,5,E+F,Man Kam To,Departure,0,0,0,0
5/17/2020,Q2,5,E+F,Sha Tau Kok,Arrival,0,0,0,0
5/17/2020,Q2,5,E+F,Sha Tau Kok,Departure,0,0,0,0
5/17/2020,Q2,5,E+F,Shenzhen Bay,Arrival,1169,182,10,1361
5/17/2020,Q2,5,E+F,Shenzhen Bay,Departure,195,40,1,236
5/17/2020,Q2,5,E+F,China Ferry Terminal,Arrival,0,0,0,0
5/17/2020,Q2,5,E+F,China Ferry Terminal,Departure,0,0,0,0
5/17/2020,Q2,5,E+F,Harbour Control,Arrival,0,0,0,0
5/17/2020,Q2,5,E+F,Harbour Control,Departure,0,0,0,0
5/17/2020,Q2,5,E+F,Kai Tak Cruise Terminal,Arrival,0,0,0,0
5/17/2020,Q2,5,E+F,Kai Tak Cruise Terminal,Departure,0,0,0,0
5/17/2020,Q2,5,E+F,Macau Ferry Terminal,Arrival,0,0,0,0
5/17/2020,Q2,5,E+F,Macau Ferry Terminal,Departure,0,0,0,0
5/17/2020,Q2,5,E+F,Tuen Mun Ferry Terminal,Arrival,0,0,0,0
5/17/2020,Q2,5,E+F,Tuen Mun Ferry Terminal,Departure,0,0,0,0
5/18/2020,Q2,5,E+F,Airport,Arrival,997,6,39,1042
5/18/2020,Q2,5,E+F,Airport,Departure,261,9,62,332
5/18/2020,Q2,5,E+F,Express Rail Link West Kowloon,Arrival,0,0,0,0
5/18/2020,Q2,5,E+F,Express Rail Link West Kowloon,Departure,0,0,0,0
5/18/2020,Q2,5,E+F,Hung Hom,Arrival,0,0,0,0
5/18/2020,Q2,5,E+F,Hung Hom,Departure,0,0,0,0
5/18/2020,Q2,5,E+F,Lo Wu,Arrival,0,0,0,0
5/18/2020,Q2,5,E+F,Lo Wu,Departure,0,0,0,0
5/18/2020,Q2,5,E+F,Lok Ma Chau Spur Line,Arrival,0,0,0,0
5/18/2020,Q2,5,E+F,Lok Ma Chau Spur Line,Departure,0,0,0,0
5/18/2020,Q2,5,E+F,Hong Kong-Zhuhai-Macao Bridge,Arrival,84,6,14,104
5/18/2020,Q2,5,E+F,Hong Kong-Zhuhai-Macao Bridge,Departure,26,0,2,28
5/18/2020,Q2,5,E+F,Lok Ma Chau,Arrival,0,0,0,0
5/18/2020,Q2,5,E+F,Lok Ma Chau,Departure,0,0,0,0
5/18/2020,Q2,5,E+F,Man Kam To,Arrival,0,0,0,0
5/18/2020,Q2,5,E+F,Man Kam To,Departure,0,0,0,0
5/18/2020,Q2,5,E+F,Sha Tau Kok,Arrival,0,0,0,0
5/18/2020,Q2,5,E+F,Sha Tau Kok,Departure,0,0,0,0
5/18/2020,Q2,5,E+F,Shenzhen Bay,Arrival,938,125,13,1076
5/18/2020,Q2,5,E+F,Shenzhen Bay,Departure,348,39,2,389
5/18/2020,Q2,5,E+F,China Ferry Terminal,Arrival,0,0,0,0
5/18/2020,Q2,5,E+F,China Ferry Terminal,Departure,0,0,0,0
5/18/2020,Q2,5,E+F,Harbour Control,Arrival,0,0,0,0
5/18/2020,Q2,5,E+F,Harbour Control,Departure,0,0,0,0
5/18/2020,Q2,5,E+F,Kai Tak Cruise Terminal,Arrival,0,0,0,0
5/18/2020,Q2,5,E+F,Kai Tak Cruise Terminal,Departure,0,0,0,0
5/18/2020,Q2,5,E+F,Macau Ferry Terminal,Arrival,0,0,0,0
5/18/2020,Q2,5,E+F,Macau Ferry Terminal,Departure,0,0,0,0
5/18/2020,Q2,5,E+F,Tuen Mun Ferry Terminal,Arrival,0,0,0,0
5/18/2020,Q2,5,E+F,Tuen Mun Ferry Terminal,Departure,0,0,0,0
5/19/2020,Q2,5,E+F,Airport,Arrival,385,0,14,399
5/19/2020,Q2,5,E+F,Airport,Departure,144,2,18,164
5/19/2020,Q2,5,E+F,Express Rail Link West Kowloon,Arrival,0,0,0,0
5/19/2020,Q2,5,E+F,Express Rail Link West Kowloon,Departure,0,0,0,0
5/19/2020,Q2,5,E+F,Hung Hom,Arrival,0,0,0,0
5/19/2020,Q2,5,E+F,Hung Hom,Departure,0,0,0,0
5/19/2020,Q2,5,E+F,Lo Wu,Arrival,0,0,0,0
5/19/2020,Q2,5,E+F,Lo Wu,Departure,0,0,0,0
5/19/2020,Q2,5,E+F,Lok Ma Chau Spur Line,Arrival,0,0,0,0
5/19/2020,Q2,5,E+F,Lok Ma Chau Spur Line,Departure,0,0,0,0
5/19/2020,Q2,5,E+F,Hong Kong-Zhuhai-Macao Bridge,Arrival,68,5,10,83
5/19/2020,Q2,5,E+F,Hong Kong-Zhuhai-Macao Bridge,Departure,20,1,1,22
5/19/2020,Q2,5,E+F,Lok Ma Chau,Arrival,0,0,0,0
5/19/2020,Q2,5,E+F,Lok Ma Chau,Departure,0,0,0,0
5/19/2020,Q2,5,E+F,Man Kam To,Arrival,0,0,0,0
5/19/2020,Q2,5,E+F,Man Kam To,Departure,0,0,0,0
5/19/2020,Q2,5,E+F,Sha Tau Kok,Arrival,0,0,0,0
5/19/2020,Q2,5,E+F,Sha Tau Kok,Departure,0,0,0,0
5/19/2020,Q2,5,E+F,Shenzhen Bay,Arrival,889,115,8,1012
5/19/2020,Q2,5,E+F,Shenzhen Bay,Departure,454,37,5,496
5/19/2020,Q2,5,E+F,China Ferry Terminal,Arrival,0,0,0,0
5/19/2020,Q2,5,E+F,China Ferry Terminal,Departure,0,0,0,0
5/19/2020,Q2,5,E+F,Harbour Control,Arrival,0,0,0,0
5/19/2020,Q2,5,E+F,Harbour Control,Departure,0,0,0,0
5/19/2020,Q2,5,E+F,Kai Tak Cruise Terminal,Arrival,0,0,0,0
5/19/2020,Q2,5,E+F,Kai Tak Cruise Terminal,Departure,0,0,0,0
5/19/2020,Q2,5,E+F,Macau Ferry Terminal,Arrival,0,0,0,0
5/19/2020,Q2,5,E+F,Macau Ferry Terminal,Departure,0,0,0,0
5/19/2020,Q2,5,E+F,Tuen Mun Ferry Terminal,Arrival,0,0,0,0
5/19/2020,Q2,5,E+F,Tuen Mun Ferry Terminal,Departure,0,0,0,0
5/20/2020,Q2,5,E+F,Airport,Arrival,787,5,20,812
5/20/2020,Q2,5,E+F,Airport,Departure,230,8,26,264
5/20/2020,Q2,5,E+F,Express Rail Link West Kowloon,Arrival,0,0,0,0
5/20/2020,Q2,5,E+F,Express Rail Link West Kowloon,Departure,0,0,0,0
5/20/2020,Q2,5,E+F,Hung Hom,Arrival,0,0,0,0
5/20/2020,Q2,5,E+F,Hung Hom,Departure,0,0,0,0
5/20/2020,Q2,5,E+F,Lo Wu,Arrival,0,0,0,0
5/20/2020,Q2,5,E+F,Lo Wu,Departure,0,0,0,0
5/20/2020,Q2,5,E+F,Lok Ma Chau Spur Line,Arrival,0,0,0,0
5/20/2020,Q2,5,E+F,Lok Ma Chau Spur Line,Departure,0,0,0,0
5/20/2020,Q2,5,E+F,Hong Kong-Zhuhai-Macao Bridge,Arrival,70,9,6,85
5/20/2020,Q2,5,E+F,Hong Kong-Zhuhai-Macao Bridge,Departure,22,3,1,26
5/20/2020,Q2,5,E+F,Lok Ma Chau,Arrival,0,0,0,0
5/20/2020,Q2,5,E+F,Lok Ma Chau,Departure,0,0,0,0
5/20/2020,Q2,5,E+F,Man Kam To,Arrival,0,0,0,0
5/20/2020,Q2,5,E+F,Man Kam To,Departure,0,0,0,0
5/20/2020,Q2,5,E+F,Sha Tau Kok,Arrival,0,0,0,0
5/20/2020,Q2,5,E+F,Sha Tau Kok,Departure,0,0,0,0
5/20/2020,Q2,5,E+F,Shenzhen Bay,Arrival,1019,135,13,1167
5/20/2020,Q2,5,E+F,Shenzhen Bay,Departure,262,41,1,304
5/20/2020,Q2,5,E+F,China Ferry Terminal,Arrival,0,0,0,0
5/20/2020,Q2,5,E+F,China Ferry Terminal,Departure,0,0,0,0
5/20/2020,Q2,5,E+F,Harbour Control,Arrival,0,0,0,0
5/20/2020,Q2,5,E+F,Harbour Control,Departure,0,0,0,0
5/20/2020,Q2,5,E+F,Kai Tak Cruise Terminal,Arrival,0,0,0,0
5/20/2020,Q2,5,E+F,Kai Tak Cruise Terminal,Departure,0,0,0,0
5/20/2020,Q2,5,E+F,Macau Ferry Terminal,Arrival,0,0,0,0
5/20/2020,Q2,5,E+F,Macau Ferry Terminal,Departure,0,0,0,0
5/20/2020,Q2,5,E+F,Tuen Mun Ferry Terminal,Arrival,0,0,0,0
5/20/2020,Q2,5,E+F,Tuen Mun Ferry Terminal,Departure,0,0,0,0
5/21/2020,Q2,5,E+F,Airport,Arrival,474,8,30,512
5/21/2020,Q2,5,E+F,Airport,Departure,147,8,32,187
5/21/2020,Q2,5,E+F,Express Rail Link West Kowloon,Arrival,0,0,0,0
5/21/2020,Q2,5,E+F,Express Rail Link West Kowloon,Departure,0,0,0,0
5/21/2020,Q2,5,E+F,Hung Hom,Arrival,0,0,0,0
5/21/2020,Q2,5,E+F,Hung Hom,Departure,0,0,0,0
5/21/2020,Q2,5,E+F,Lo Wu,Arrival,0,0,0,0
5/21/2020,Q2,5,E+F,Lo Wu,Departure,0,0,0,0
5/21/2020,Q2,5,E+F,Lok Ma Chau Spur Line,Arrival,0,0,0,0
5/21/2020,Q2,5,E+F,Lok Ma Chau Spur Line,Departure,0,0,0,0
5/21/2020,Q2,5,E+F,Hong Kong-Zhuhai-Macao Bridge,Arrival,106,4,5,115
5/21/2020,Q2,5,E+F,Hong Kong-Zhuhai-Macao Bridge,Departure,23,1,2,26
5/21/2020,Q2,5,E+F,Lok Ma Chau,Arrival,0,0,0,0
5/21/2020,Q2,5,E+F,Lok Ma Chau,Departure,0,0,0,0
5/21/2020,Q2,5,E+F,Man Kam To,Arrival,0,0,0,0
5/21/2020,Q2,5,E+F,Man Kam To,Departure,0,0,0,0
5/21/2020,Q2,5,E+F,Sha Tau Kok,Arrival,0,0,0,0
5/21/2020,Q2,5,E+F,Sha Tau Kok,Departure,0,0,0,0
5/21/2020,Q2,5,E+F,Shenzhen Bay,Arrival,1121,127,9,1257
5/21/2020,Q2,5,E+F,Shenzhen Bay,Departure,256,79,1,336
5/21/2020,Q2,5,E+F,China Ferry Terminal,Arrival,0,0,0,0
5/21/2020,Q2,5,E+F,China Ferry Terminal,Departure,0,0,0,0
5/21/2020,Q2,5,E+F,Harbour Control,Arrival,0,0,0,0
5/21/2020,Q2,5,E+F,Harbour Control,Departure,0,0,0,0
5/21/2020,Q2,5,E+F,Kai Tak Cruise Terminal,Arrival,0,0,0,0
5/21/2020,Q2,5,E+F,Kai Tak Cruise Terminal,Departure,0,0,0,0
5/21/2020,Q2,5,E+F,Macau Ferry Terminal,Arrival,0,0,0,0
5/21/2020,Q2,5,E+F,Macau Ferry Terminal,Departure,0,0,0,0
5/21/2020,Q2,5,E+F,Tuen Mun Ferry Terminal,Arrival,0,0,0,0
5/21/2020,Q2,5,E+F,Tuen Mun Ferry Terminal,Departure,0,0,0,0
5/22/2020,Q2,5,E+F,Airport,Arrival,1089,7,31,1127
5/22/2020,Q2,5,E+F,Airport,Departure,336,4,55,395
5/22/2020,Q2,5,E+F,Express Rail Link West Kowloon,Arrival,0,0,0,0
5/22/2020,Q2,5,E+F,Express Rail Link West Kowloon,Departure,0,0,0,0
5/22/2020,Q2,5,E+F,Hung Hom,Arrival,0,0,0,0
5/22/2020,Q2,5,E+F,Hung Hom,Departure,0,0,0,0
5/22/2020,Q2,5,E+F,Lo Wu,Arrival,0,0,0,0
5/22/2020,Q2,5,E+F,Lo Wu,Departure,0,0,0,0
5/22/2020,Q2,5,E+F,Lok Ma Chau Spur Line,Arrival,0,0,0,0
5/22/2020,Q2,5,E+F,Lok Ma Chau Spur Line,Departure,0,0,0,0
5/22/2020,Q2,5,E+F,Hong Kong-Zhuhai-Macao Bridge,Arrival,69,4,4,77
5/22/2020,Q2,5,E+F,Hong Kong-Zhuhai-Macao Bridge,Departure,31,1,1,33
5/22/2020,Q2,5,E+F,Lok Ma Chau,Arrival,0,0,0,0
5/22/2020,Q2,5,E+F,Lok Ma Chau,Departure,0,0,0,0
5/22/2020,Q2,5,E+F,Man Kam To,Arrival,0,0,0,0
5/22/2020,Q2,5,E+F,Man Kam To,Departure,0,0,0,0
5/22/2020,Q2,5,E+F,Sha Tau Kok,Arrival,0,0,0,0
5/22/2020,Q2,5,E+F,Sha Tau Kok,Departure,0,0,0,0
5/22/2020,Q2,5,E+F,Shenzhen Bay,Arrival,1121,154,17,1292
5/22/2020,Q2,5,E+F,Shenzhen Bay,Departure,300,70,1,371
5/22/2020,Q2,5,E+F,China Ferry Terminal,Arrival,0,0,0,0
5/22/2020,Q2,5,E+F,China Ferry Terminal,Departure,0,0,0,0
5/22/2020,Q2,5,E+F,Harbour Control,Arrival,0,0,0,0
5/22/2020,Q2,5,E+F,Harbour Control,Departure,0,0,0,0
5/22/2020,Q2,5,E+F,Kai Tak Cruise Terminal,Arrival,0,0,0,0
5/22/2020,Q2,5,E+F,Kai Tak Cruise Terminal,Departure,0,0,0,0
5/22/2020,Q2,5,E+F,Macau Ferry Terminal,Arrival,0,0,0,0
5/22/2020,Q2,5,E+F,Macau Ferry Terminal,Departure,0,0,0,0
5/22/2020,Q2,5,E+F,Tuen Mun Ferry Terminal,Arrival,0,0,0,0
5/22/2020,Q2,5,E+F,Tuen Mun Ferry Terminal,Departure,0,0,0,0
5/23/2020,Q2,5,E+F,Airport,Arrival,534,5,102,641
5/23/2020,Q2,5,E+F,Airport,Departure,202,12,35,249
5/23/2020,Q2,5,E+F,Express Rail Link West Kowloon,Arrival,0,0,0,0
5/23/2020,Q2,5,E+F,Express Rail Link West Kowloon,Departure,0,0,0,0
5/23/2020,Q2,5,E+F,Hung Hom,Arrival,0,0,0,0
5/23/2020,Q2,5,E+F,Hung Hom,Departure,0,0,0,0
5/23/2020,Q2,5,E+F,Lo Wu,Arrival,0,0,0,0
5/23/2020,Q2,5,E+F,Lo Wu,Departure,0,0,0,0
5/23/2020,Q2,5,E+F,Lok Ma Chau Spur Line,Arrival,0,0,0,0
5/23/2020,Q2,5,E+F,Lok Ma Chau Spur Line,Departure,0,0,0,0
5/23/2020,Q2,5,E+F,Hong Kong-Zhuhai-Macao Bridge,Arrival,118,12,3,133
5/23/2020,Q2,5,E+F,Hong Kong-Zhuhai-Macao Bridge,Departure,10,1,6,17
5/23/2020,Q2,5,E+F,Lok Ma Chau,Arrival,0,0,0,0
5/23/2020,Q2,5,E+F,Lok Ma Chau,Departure,0,0,0,0
5/23/2020,Q2,5,E+F,Man Kam To,Arrival,0,0,0,0
5/23/2020,Q2,5,E+F,Man Kam To,Departure,0,0,0,0
5/23/2020,Q2,5,E+F,Sha Tau Kok,Arrival,0,0,0,0
5/23/2020,Q2,5,E+F,Sha Tau Kok,Departure,0,0,0,0
5/23/2020,Q2,5,E+F,Shenzhen Bay,Arrival,1802,270,11,2083
5/23/2020,Q2,5,E+F,Shenzhen Bay,Departure,210,39,11,260
5/23/2020,Q2,5,E+F,China Ferry Terminal,Arrival,0,0,0,0
5/23/2020,Q2,5,E+F,China Ferry Terminal,Departure,0,0,0,0
5/23/2020,Q2,5,E+F,Harbour Control,Arrival,0,0,0,0
5/23/2020,Q2,5,E+F,Harbour Control,Departure,0,0,0,0
5/23/2020,Q2,5,E+F,Kai Tak Cruise Terminal,Arrival,0,0,0,0
5/23/2020,Q2,5,E+F,Kai Tak Cruise Terminal,Departure,0,0,0,0
5/23/2020,Q2,5,E+F,Macau Ferry Terminal,Arrival,0,0,0,0
5/23/2020,Q2,5,E+F,Macau Ferry Terminal,Departure,0,0,0,0
5/23/2020,Q2,5,E+F,Tuen Mun Ferry Terminal,Arrival,0,0,0,0
5/23/2020,Q2,5,E+F,Tuen Mun Ferry Terminal,Departure,0,0,0,0
5/24/2020,Q2,5,E+F,Airport,Arrival,1048,10,38,1096
5/24/2020,Q2,5,E+F,Airport,Departure,237,9,40,286
5/24/2020,Q2,5,E+F,Express Rail Link West Kowloon,Arrival,0,0,0,0
5/24/2020,Q2,5,E+F,Express Rail Link West Kowloon,Departure,0,0,0,0
5/24/2020,Q2,5,E+F,Hung Hom,Arrival,0,0,0,0
5/24/2020,Q2,5,E+F,Hung Hom,Departure,0,0,0,0
5/24/2020,Q2,5,E+F,Lo Wu,Arrival,0,0,0,0
5/24/2020,Q2,5,E+F,Lo Wu,Departure,0,0,0,0
5/24/2020,Q2,5,E+F,Lok Ma Chau Spur Line,Arrival,0,0,0,0
5/24/2020,Q2,5,E+F,Lok Ma Chau Spur Line,Departure,0,0,0,0
5/24/2020,Q2,5,E+F,Hong Kong-Zhuhai-Macao Bridge,Arrival,123,15,2,140
5/24/2020,Q2,5,E+F,Hong Kong-Zhuhai-Macao Bridge,Departure,27,0,2,29
5/24/2020,Q2,5,E+F,Lok Ma Chau,Arrival,0,0,0,0
5/24/2020,Q2,5,E+F,Lok Ma Chau,Departure,0,0,0,0
5/24/2020,Q2,5,E+F,Man Kam To,Arrival,0,0,0,0
5/24/2020,Q2,5,E+F,Man Kam To,Departure,0,0,0,0
5/24/2020,Q2,5,E+F,Sha Tau Kok,Arrival,0,0,0,0
5/24/2020,Q2,5,E+F,Sha Tau Kok,Departure,0,0,0,0
5/24/2020,Q2,5,E+F,Shenzhen Bay,Arrival,2458,439,14,2911
5/24/2020,Q2,5,E+F,Shenzhen Bay,Departure,210,35,3,248
5/24/2020,Q2,5,E+F,China Ferry Terminal,Arrival,0,0,0,0
5/24/2020,Q2,5,E+F,China Ferry Terminal,Departure,0,0,0,0
5/24/2020,Q2,5,E+F,Harbour Control,Arrival,0,0,0,0
5/24/2020,Q2,5,E+F,Harbour Control,Departure,0,0,0,0
5/24/2020,Q2,5,E+F,Kai Tak Cruise Terminal,Arrival,0,0,0,0
5/24/2020,Q2,5,E+F,Kai Tak Cruise Terminal,Departure,0,0,0,0
5/24/2020,Q2,5,E+F,Macau Ferry Terminal,Arrival,0,0,0,0
5/24/2020,Q2,5,E+F,Macau Ferry Terminal,Departure,0,0,0,0
5/24/2020,Q2,5,E+F,Tuen Mun Ferry Terminal,Arrival,0,0,0,0
5/24/2020,Q2,5,E+F,Tuen Mun Ferry Terminal,Departure,0,0,0,0
5/25/2020,Q2,5,E+F,Airport,Arrival,673,6,46,725
5/25/2020,Q2,5,E+F,Airport,Departure,156,4,23,183
5/25/2020,Q2,5,E+F,Express Rail Link West Kowloon,Arrival,0,0,0,0
5/25/2020,Q2,5,E+F,Express Rail Link West Kowloon,Departure,0,0,0,0
5/25/2020,Q2,5,E+F,Hung Hom,Arrival,0,0,0,0
5/25/2020,Q2,5,E+F,Hung Hom,Departure,0,0,0,0
5/25/2020,Q2,5,E+F,Lo Wu,Arrival,0,0,0,0
5/25/2020,Q2,5,E+F,Lo Wu,Departure,0,0,0,0
5/25/2020,Q2,5,E+F,Lok Ma Chau Spur Line,Arrival,0,0,0,0
5/25/2020,Q2,5,E+F,Lok Ma Chau Spur Line,Departure,0,0,0,0
5/25/2020,Q2,5,E+F,Hong Kong-Zhuhai-Macao Bridge,Arrival,99,8,8,115
5/25/2020,Q2,5,E+F,Hong Kong-Zhuhai-Macao Bridge,Departure,48,0,3,51
5/25/2020,Q2,5,E+F,Lok Ma Chau,Arrival,0,0,0,0
5/25/2020,Q2,5,E+F,Lok Ma Chau,Departure,0,0,0,0
5/25/2020,Q2,5,E+F,Man Kam To,Arrival,0,0,0,0
5/25/2020,Q2,5,E+F,Man Kam To,Departure,0,0,0,0
5/25/2020,Q2,5,E+F,Sha Tau Kok,Arrival,0,0,0,0
5/25/2020,Q2,5,E+F,Sha Tau Kok,Departure,0,0,0,0
5/25/2020,Q2,5,E+F,Shenzhen Bay,Arrival,1469,255,6,1730
5/25/2020,Q2,5,E+F,Shenzhen Bay,Departure,376,18,6,400
5/25/2020,Q2,5,E+F,China Ferry Terminal,Arrival,0,0,0,0
5/25/2020,Q2,5,E+F,China Ferry Terminal,Departure,0,0,0,0
5/25/2020,Q2,5,E+F,Harbour Control,Arrival,0,0,0,0
5/25/2020,Q2,5,E+F,Harbour Control,Departure,0,0,0,0
5/25/2020,Q2,5,E+F,Kai Tak Cruise Terminal,Arrival,0,0,0,0
5/25/2020,Q2,5,E+F,Kai Tak Cruise Terminal,Departure,0,0,0,0
5/25/2020,Q2,5,E+F,Macau Ferry Terminal,Arrival,0,0,0,0
5/25/2020,Q2,5,E+F,Macau Ferry Terminal,Departure,0,0,0,0
5/25/2020,Q2,5,E+F,Tuen Mun Ferry Terminal,Arrival,0,0,0,0
5/25/2020,Q2,5,E+F,Tuen Mun Ferry Terminal,Departure,0,0,0,0
5/26/2020,Q2,5,E+F,Airport,Arrival,543,2,37,582
5/26/2020,Q2,5,E+F,Airport,Departure,252,3,53,308
5/26/2020,Q2,5,E+F,Express Rail Link West Kowloon,Arrival,0,0,0,0
5/26/2020,Q2,5,E+F,Express Rail Link West Kowloon,Departure,0,0,0,0
5/26/2020,Q2,5,E+F,Hung Hom,Arrival,0,0,0,0
5/26/2020,Q2,5,E+F,Hung Hom,Departure,0,0,0,0
5/26/2020,Q2,5,E+F,Lo Wu,Arrival,0,0,0,0
5/26/2020,Q2,5,E+F,Lo Wu,Departure,0,0,0,0
5/26/2020,Q2,5,E+F,Lok Ma Chau Spur Line,Arrival,0,0,0,0
5/26/2020,Q2,5,E+F,Lok Ma Chau Spur Line,Departure,0,0,0,0
5/26/2020,Q2,5,E+F,Hong Kong-Zhuhai-Macao Bridge,Arrival,60,11,8,79
5/26/2020,Q2,5,E+F,Hong Kong-Zhuhai-Macao Bridge,Departure,23,0,2,25
5/26/2020,Q2,5,E+F,Lok Ma Chau,Arrival,0,0,0,0
5/26/2020,Q2,5,E+F,Lok Ma Chau,Departure,0,0,0,0
5/26/2020,Q2,5,E+F,Man Kam To,Arrival,0,0,0,0
5/26/2020,Q2,5,E+F,Man Kam To,Departure,0,0,0,0
5/26/2020,Q2,5,E+F,Sha Tau Kok,Arrival,0,0,0,0
5/26/2020,Q2,5,E+F,Sha Tau Kok,Departure,0,0,0,0
5/26/2020,Q2,5,E+F,Shenzhen Bay,Arrival,790,142,12,944
5/26/2020,Q2,5,E+F,Shenzhen Bay,Departure,213,31,2,246
5/26/2020,Q2,5,E+F,China Ferry Terminal,Arrival,0,0,0,0
5/26/2020,Q2,5,E+F,China Ferry Terminal,Departure,0,0,0,0
5/26/2020,Q2,5,E+F,Harbour Control,Arrival,0,0,0,0
5/26/2020,Q2,5,E+F,Harbour Control,Departure,0,0,0,0
5/26/2020,Q2,5,E+F,Kai Tak Cruise Terminal,Arrival,0,0,0,0
5/26/2020,Q2,5,E+F,Kai Tak Cruise Terminal,Departure,0,0,0,0
5/26/2020,Q2,5,E+F,Macau Ferry Terminal,Arrival,0,0,0,0
5/26/2020,Q2,5,E+F,Macau Ferry Terminal,Departure,0,0,0,0
5/26/2020,Q2,5,E+F,Tuen Mun Ferry Terminal,Arrival,0,0,0,0
5/26/2020,Q2,5,E+F,Tuen Mun Ferry Terminal,Departure,0,0,0,0
5/27/2020,Q2,5,E+F,Airport,Arrival,485,4,21,510
5/27/2020,Q2,5,E+F,Airport,Departure,331,9,149,489
5/27/2020,Q2,5,E+F,Express Rail Link West Kowloon,Arrival,0,0,0,0
5/27/2020,Q2,5,E+F,Express Rail Link West Kowloon,Departure,0,0,0,0
5/27/2020,Q2,5,E+F,Hung Hom,Arrival,0,0,0,0
5/27/2020,Q2,5,E+F,Hung Hom,Departure,0,0,0,0
5/27/2020,Q2,5,E+F,Lo Wu,Arrival,0,0,0,0
5/27/2020,Q2,5,E+F,Lo Wu,Departure,0,0,0,0
5/27/2020,Q2,5,E+F,Lok Ma Chau Spur Line,Arrival,0,0,0,0
5/27/2020,Q2,5,E+F,Lok Ma Chau Spur Line,Departure,0,0,0,0
5/27/2020,Q2,5,E+F,Hong Kong-Zhuhai-Macao Bridge,Arrival,51,9,5,65
5/27/2020,Q2,5,E+F,Hong Kong-Zhuhai-Macao Bridge,Departure,17,0,0,17
5/27/2020,Q2,5,E+F,Lok Ma Chau,Arrival,0,0,0,0
5/27/2020,Q2,5,E+F,Lok Ma Chau,Departure,0,0,0,0
5/27/2020,Q2,5,E+F,Man Kam To,Arrival,0,0,0,0
5/27/2020,Q2,5,E+F,Man Kam To,Departure,0,0,0,0
5/27/2020,Q2,5,E+F,Sha Tau Kok,Arrival,0,0,0,0
5/27/2020,Q2,5,E+F,Sha Tau Kok,Departure,0,0,0,0
5/27/2020,Q2,5,E+F,Shenzhen Bay,Arrival,694,107,4,805
5/27/2020,Q2,5,E+F,Shenzhen Bay,Departure,247,34,0,281
5/27/2020,Q2,5,E+F,China Ferry Terminal,Arrival,0,0,0,0
5/27/2020,Q2,5,E+F,China Ferry Terminal,Departure,0,0,0,0
5/27/2020,Q2,5,E+F,Harbour Control,Arrival,0,0,0,0
5/27/2020,Q2,5,E+F,Harbour Control,Departure,0,0,0,0
5/27/2020,Q2,5,E+F,Kai Tak Cruise Terminal,Arrival,0,0,0,0
5/27/2020,Q2,5,E+F,Kai Tak Cruise Terminal,Departure,0,0,0,0
5/27/2020,Q2,5,E+F,Macau Ferry Terminal,Arrival,0,0,0,0
5/27/2020,Q2,5,E+F,Macau Ferry Terminal,Departure,0,0,0,0
5/27/2020,Q2,5,E+F,Tuen Mun Ferry Terminal,Arrival,0,0,0,0
5/27/2020,Q2,5,E+F,Tuen Mun Ferry Terminal,Departure,0,0,0,0
5/28/2020,Q2,5,E+F,Airport,Arrival,661,2,29,692
5/28/2020,Q2,5,E+F,Airport,Departure,195,7,71,273
5/28/2020,Q2,5,E+F,Express Rail Link West Kowloon,Arrival,0,0,0,0
5/28/2020,Q2,5,E+F,Express Rail Link West Kowloon,Departure,0,0,0,0
5/28/2020,Q2,5,E+F,Hung Hom,Arrival,0,0,0,0
5/28/2020,Q2,5,E+F,Hung Hom,Departure,0,0,0,0
5/28/2020,Q2,5,E+F,Lo Wu,Arrival,0,0,0,0
5/28/2020,Q2,5,E+F,Lo Wu,Departure,0,0,0,0
5/28/2020,Q2,5,E+F,Lok Ma Chau Spur Line,Arrival,0,0,0,0
5/28/2020,Q2,5,E+F,Lok Ma Chau Spur Line,Departure,0,0,0,0
5/28/2020,Q2,5,E+F,Hong Kong-Zhuhai-Macao Bridge,Arrival,39,0,41,80
5/28/2020,Q2,5,E+F,Hong Kong-Zhuhai-Macao Bridge,Departure,17,0,0,17
5/28/2020,Q2,5,E+F,Lok Ma Chau,Arrival,0,0,0,0
5/28/2020,Q2,5,E+F,Lok Ma Chau,Departure,0,0,0,0
5/28/2020,Q2,5,E+F,Man Kam To,Arrival,0,0,0,0
5/28/2020,Q2,5,E+F,Man Kam To,Departure,0,0,0,0
5/28/2020,Q2,5,E+F,Sha Tau Kok,Arrival,0,0,0,0
5/28/2020,Q2,5,E+F,Sha Tau Kok,Departure,0,0,0,0
5/28/2020,Q2,5,E+F,Shenzhen Bay,Arrival,676,114,10,800
5/28/2020,Q2,5,E+F,Shenzhen Bay,Departure,216,27,2,245
5/28/2020,Q2,5,E+F,China Ferry Terminal,Arrival,0,0,0,0
5/28/2020,Q2,5,E+F,China Ferry Terminal,Departure,0,0,0,0
5/28/2020,Q2,5,E+F,Harbour Control,Arrival,0,0,0,0
5/28/2020,Q2,5,E+F,Harbour Control,Departure,0,0,0,0
5/28/2020,Q2,5,E+F,Kai Tak Cruise Terminal,Arrival,0,0,0,0
5/28/2020,Q2,5,E+F,Kai Tak Cruise Terminal,Departure,0,0,0,0
5/28/2020,Q2,5,E+F,Macau Ferry Terminal,Arrival,0,0,0,0
5/28/2020,Q2,5,E+F,Macau Ferry Terminal,Departure,0,0,0,0
5/28/2020,Q2,5,E+F,Tuen Mun Ferry Terminal,Arrival,0,0,0,0
5/28/2020,Q2,5,E+F,Tuen Mun Ferry Terminal,Departure,0,0,0,0
5/29/2020,Q2,5,E+F,Airport,Arrival,923,4,22,949
5/29/2020,Q2,5,E+F,Airport,Departure,264,2,65,331
5/29/2020,Q2,5,E+F,Express Rail Link West Kowloon,Arrival,0,0,0,0
5/29/2020,Q2,5,E+F,Express Rail Link West Kowloon,Departure,0,0,0,0
5/29/2020,Q2,5,E+F,Hung Hom,Arrival,0,0,0,0
5/29/2020,Q2,5,E+F,Hung Hom,Departure,0,0,0,0
5/29/2020,Q2,5,E+F,Lo Wu,Arrival,0,0,0,0
5/29/2020,Q2,5,E+F,Lo Wu,Departure,0,0,0,0
5/29/2020,Q2,5,E+F,Lok Ma Chau Spur Line,Arrival,0,0,0,0
5/29/2020,Q2,5,E+F,Lok Ma Chau Spur Line,Departure,0,0,0,0
5/29/2020,Q2,5,E+F,Hong Kong-Zhuhai-Macao Bridge,Arrival,71,4,15,90
5/29/2020,Q2,5,E+F,Hong Kong-Zhuhai-Macao Bridge,Departure,13,0,3,16
5/29/2020,Q2,5,E+F,Lok Ma Chau,Arrival,0,0,0,0
5/29/2020,Q2,5,E+F,Lok Ma Chau,Departure,0,0,0,0
5/29/2020,Q2,5,E+F,Man Kam To,Arrival,0,0,0,0
5/29/2020,Q2,5,E+F,Man Kam To,Departure,0,0,0,0
5/29/2020,Q2,5,E+F,Sha Tau Kok,Arrival,0,0,0,0
5/29/2020,Q2,5,E+F,Sha Tau Kok,Departure,0,0,0,0
5/29/2020,Q2,5,E+F,Shenzhen Bay,Arrival,695,106,8,809
5/29/2020,Q2,5,E+F,Shenzhen Bay,Departure,209,24,53,286
5/29/2020,Q2,5,E+F,China Ferry Terminal,Arrival,0,0,0,0
5/29/2020,Q2,5,E+F,China Ferry Terminal,Departure,0,0,0,0
5/29/2020,Q2,5,E+F,Harbour Control,Arrival,0,0,0,0
5/29/2020,Q2,5,E+F,Harbour Control,Departure,0,0,0,0
5/29/2020,Q2,5,E+F,Kai Tak Cruise Terminal,Arrival,0,0,0,0
5/29/2020,Q2,5,E+F,Kai Tak Cruise Terminal,Departure,0,0,0,0
5/29/2020,Q2,5,E+F,Macau Ferry Terminal,Arrival,0,0,0,0
5/29/2020,Q2,5,E+F,Macau Ferry Terminal,Departure,0,0,0,0
5/29/2020,Q2,5,E+F,Tuen Mun Ferry Terminal,Arrival,0,0,0,0
5/29/2020,Q2,5,E+F,Tuen Mun Ferry Terminal,Departure,0,0,0,0
5/30/2020,Q2,5,E+F,Airport,Arrival,599,7,35,641
5/30/2020,Q2,5,E+F,Airport,Departure,414,7,48,469
5/30/2020,Q2,5,E+F,Express Rail Link West Kowloon,Arrival,0,0,0,0
5/30/2020,Q2,5,E+F,Express Rail Link West Kowloon,Departure,0,0,0,0
5/30/2020,Q2,5,E+F,Hung Hom,Arrival,0,0,0,0
5/30/2020,Q2,5,E+F,Hung Hom,Departure,0,0,0,0
5/30/2020,Q2,5,E+F,Lo Wu,Arrival,0,0,0,0
5/30/2020,Q2,5,E+F,Lo Wu,Departure,0,0,0,0
5/30/2020,Q2,5,E+F,Lok Ma Chau Spur Line,Arrival,0,0,0,0
5/30/2020,Q2,5,E+F,Lok Ma Chau Spur Line,Departure,0,0,0,0
5/30/2020,Q2,5,E+F,Hong Kong-Zhuhai-Macao Bridge,Arrival,57,5,2,64
5/30/2020,Q2,5,E+F,Hong Kong-Zhuhai-Macao Bridge,Departure,16,1,1,18
5/30/2020,Q2,5,E+F,Lok Ma Chau,Arrival,0,0,0,0
5/30/2020,Q2,5,E+F,Lok Ma Chau,Departure,0,0,0,0
5/30/2020,Q2,5,E+F,Man Kam To,Arrival,0,0,0,0
5/30/2020,Q2,5,E+F,Man Kam To,Departure,0,0,0,0
5/30/2020,Q2,5,E+F,Sha Tau Kok,Arrival,0,0,0,0
5/30/2020,Q2,5,E+F,Sha Tau Kok,Departure,0,0,0,0
5/30/2020,Q2,5,E+F,Shenzhen Bay,Arrival,985,149,12,1146
5/30/2020,Q2,5,E+F,Shenzhen Bay,Departure,133,37,45,215
5/30/2020,Q2,5,E+F,China Ferry Terminal,Arrival,0,0,0,0
5/30/2020,Q2,5,E+F,China Ferry Terminal,Departure,0,0,0,0
5/30/2020,Q2,5,E+F,Harbour Control,Arrival,0,0,0,0
5/30/2020,Q2,5,E+F,Harbour Control,Departure,0,0,0,0
5/30/2020,Q2,5,E+F,Kai Tak Cruise Terminal,Arrival,0,0,0,0
5/30/2020,Q2,5,E+F,Kai Tak Cruise Terminal,Departure,0,0,0,0
5/30/2020,Q2,5,E+F,Macau Ferry Terminal,Arrival,0,0,0,0
5/30/2020,Q2,5,E+F,Macau Ferry Terminal,Departure,0,0,0,0
5/30/2020,Q2,5,E+F,Tuen Mun Ferry Terminal,Arrival,0,0,0,0
5/30/2020,Q2,5,E+F,Tuen Mun Ferry Terminal,Departure,0,0,0,0
5/31/2020,Q2,5,E+F,Airport,Arrival,839,8,41,888
5/31/2020,Q2,5,E+F,Airport,Departure,191,4,38,233
5/31/2020,Q2,5,E+F,Express Rail Link West Kowloon,Arrival,0,0,0,0
5/31/2020,Q2,5,E+F,Express Rail Link West Kowloon,Departure,0,0,0,0
5/31/2020,Q2,5,E+F,Hung Hom,Arrival,0,0,0,0
5/31/2020,Q2,5,E+F,Hung Hom,Departure,0,0,0,0
5/31/2020,Q2,5,E+F,Lo Wu,Arrival,0,0,0,0
5/31/2020,Q2,5,E+F,Lo Wu,Departure,0,0,0,0
5/31/2020,Q2,5,E+F,Lok Ma Chau Spur Line,Arrival,0,0,0,0
5/31/2020,Q2,5,E+F,Lok Ma Chau Spur Line,Departure,0,0,0,0
5/31/2020,Q2,5,E+F,Hong Kong-Zhuhai-Macao Bridge,Arrival,83,11,6,100
5/31/2020,Q2,5,E+F,Hong Kong-Zhuhai-Macao Bridge,Departure,17,0,0,17
5/31/2020,Q2,5,E+F,Lok Ma Chau,Arrival,0,0,0,0
5/31/2020,Q2,5,E+F,Lok Ma Chau,Departure,0,0,0,0
5/31/2020,Q2,5,E+F,Man Kam To,Arrival,0,0,0,0
5/31/2020,Q2,5,E+F,Man Kam To,Departure,0,0,0,0
5/31/2020,Q2,5,E+F,Sha Tau Kok,Arrival,0,0,0,0
5/31/2020,Q2,5,E+F,Sha Tau Kok,Departure,0,0,0,0
5/31/2020,Q2,5,E+F,Shenzhen Bay,Arrival,1304,278,11,1593
5/31/2020,Q2,5,E+F,Shenzhen Bay,Departure,156,21,17,194
5/31/2020,Q2,5,E+F,China Ferry Terminal,Arrival,0,0,0,0
5/31/2020,Q2,5,E+F,China Ferry Terminal,Departure,0,0,0,0
5/31/2020,Q2,5,E+F,Harbour Control,Arrival,0,0,0,0
5/31/2020,Q2,5,E+F,Harbour Control,Departure,0,0,0,0
5/31/2020,Q2,5,E+F,Kai Tak Cruise Terminal,Arrival,0,0,0,0
5/31/2020,Q2,5,E+F,Kai Tak Cruise Terminal,Departure,0,0,0,0
5/31/2020,Q2,5,E+F,Macau Ferry Terminal,Arrival,0,0,0,0
5/31/2020,Q2,5,E+F,Macau Ferry Terminal,Departure,0,0,0,0
5/31/2020,Q2,5,E+F,Tuen Mun Ferry Terminal,Arrival,0,0,0,0
5/31/2020,Q2,5,E+F,Tuen Mun Ferry Terminal,Departure,0,0,0,0
6/1/2020,Q2,5,E+F,Airport,Arrival,760,9,61,830
6/1/2020,Q2,5,E+F,Airport,Departure,253,1,40,294
6/1/2020,Q2,5,E+F,Express Rail Link West Kowloon,Arrival,0,0,0,0
6/1/2020,Q2,5,E+F,Express Rail Link West Kowloon,Departure,0,0,0,0
6/1/2020,Q2,5,E+F,Hung Hom,Arrival,0,0,0,0
6/1/2020,Q2,5,E+F,Hung Hom,Departure,0,0,0,0
6/1/2020,Q2,5,E+F,Lo Wu,Arrival,0,0,0,0
6/1/2020,Q2,5,E+F,Lo Wu,Departure,0,0,0,0
6/1/2020,Q2,5,E+F,Lok Ma Chau Spur Line,Arrival,0,0,0,0
6/1/2020,Q2,5,E+F,Lok Ma Chau Spur Line,Departure,0,0,0,0
6/1/2020,Q2,5,E+F,Hong Kong-Zhuhai-Macao Bridge,Arrival,86,10,4,100
6/1/2020,Q2,5,E+F,Hong Kong-Zhuhai-Macao Bridge,Departure,40,3,3,46
6/1/2020,Q2,5,E+F,Lok Ma Chau,Arrival,0,0,0,0
6/1/2020,Q2,5,E+F,Lok Ma Chau,Departure,0,0,0,0
6/1/2020,Q2,5,E+F,Man Kam To,Arrival,0,0,0,0
6/1/2020,Q2,5,E+F,Man Kam To,Departure,0,0,0,0
6/1/2020,Q2,5,E+F,Sha Tau Kok,Arrival,0,0,0,0
6/1/2020,Q2,5,E+F,Sha Tau Kok,Departure,0,0,0,0
6/1/2020,Q2,5,E+F,Shenzhen Bay,Arrival,984,166,15,1165
6/1/2020,Q2,5,E+F,Shenzhen Bay,Departure,357,25,9,391
6/1/2020,Q2,5,E+F,China Ferry Terminal,Arrival,0,0,0,0
6/1/2020,Q2,5,E+F,China Ferry Terminal,Departure,0,0,0,0
6/1/2020,Q2,5,E+F,Harbour Control,Arrival,0,0,0,0
6/1/2020,Q2,5,E+F,Harbour Control,Departure,0,0,0,0
6/1/2020,Q2,5,E+F,Kai Tak Cruise Terminal,Arrival,0,0,0,0
6/1/2020,Q2,5,E+F,Kai Tak Cruise Terminal,Departure,0,0,0,0
6/1/2020,Q2,5,E+F,Macau Ferry Terminal,Arrival,0,0,0,0
6/1/2020,Q2,5,E+F,Macau Ferry Terminal,Departure,0,0,0,0
6/1/2020,Q2,5,E+F,Tuen Mun Ferry Terminal,Arrival,0,0,0,0
6/1/2020,Q2,5,E+F,Tuen Mun Ferry Terminal,Departure,0,0,0,0
6/2/2020,Q2,5,E+F,Airport,Arrival,1150,4,52,1206
6/2/2020,Q2,5,E+F,Airport,Departure,367,2,110,479
6/2/2020,Q2,5,E+F,Express Rail Link West Kowloon,Arrival,0,0,0,0
6/2/2020,Q2,5,E+F,Express Rail Link West Kowloon,Departure,0,0,0,0
6/2/2020,Q2,5,E+F,Hung Hom,Arrival,0,0,0,0
6/2/2020,Q2,5,E+F,Hung Hom,Departure,0,0,0,0
6/2/2020,Q2,5,E+F,Lo Wu,Arrival,0,0,0,0
6/2/2020,Q2,5,E+F,Lo Wu,Departure,0,0,0,0
6/2/2020,Q2,5,E+F,Lok Ma Chau Spur Line,Arrival,0,0,0,0
6/2/2020,Q2,5,E+F,Lok Ma Chau Spur Line,Departure,0,0,0,0
6/2/2020,Q2,5,E+F,Hong Kong-Zhuhai-Macao Bridge,Arrival,70,4,4,78
6/2/2020,Q2,5,E+F,Hong Kong-Zhuhai-Macao Bridge,Departure,32,1,3,36
6/2/2020,Q2,5,E+F,Lok Ma Chau,Arrival,0,0,0,0
6/2/2020,Q2,5,E+F,Lok Ma Chau,Departure,0,0,0,0
6/2/2020,Q2,5,E+F,Man Kam To,Arrival,0,0,0,0
6/2/2020,Q2,5,E+F,Man Kam To,Departure,0,0,0,0
6/2/2020,Q2,5,E+F,Sha Tau Kok,Arrival,0,0,0,0
6/2/2020,Q2,5,E+F,Sha Tau Kok,Departure,0,0,0,0
6/2/2020,Q2,5,E+F,Shenzhen Bay,Arrival,576,108,17,701
6/2/2020,Q2,5,E+F,Shenzhen Bay,Departure,267,30,4,301
6/2/2020,Q2,5,E+F,China Ferry Terminal,Arrival,0,0,0,0
6/2/2020,Q2,5,E+F,China Ferry Terminal,Departure,0,0,0,0
6/2/2020,Q2,5,E+F,Harbour Control,Arrival,0,0,0,0
6/2/2020,Q2,5,E+F,Harbour Control,Departure,0,0,0,0
6/2/2020,Q2,5,E+F,Kai Tak Cruise Terminal,Arrival,0,0,0,0
6/2/2020,Q2,5,E+F,Kai Tak Cruise Terminal,Departure,0,0,0,0
6/2/2020,Q2,5,E+F,Macau Ferry Terminal,Arrival,0,0,0,0
6/2/2020,Q2,5,E+F,Macau Ferry Terminal,Departure,0,0,0,0
6/2/2020,Q2,5,E+F,Tuen Mun Ferry Terminal,Arrival,0,0,0,0
6/2/2020,Q2,5,E+F,Tuen Mun Ferry Terminal,Departure,0,0,0,0
6/3/2020,Q2,5,E+F,Airport,Arrival,918,5,40,963
6/3/2020,Q2,5,E+F,Airport,Departure,404,12,120,536
6/3/2020,Q2,5,E+F,Express Rail Link West Kowloon,Arrival,0,0,0,0
6/3/2020,Q2,5,E+F,Express Rail Link West Kowloon,Departure,0,0,0,0
6/3/2020,Q2,5,E+F,Hung Hom,Arrival,0,0,0,0
6/3/2020,Q2,5,E+F,Hung Hom,Departure,0,0,0,0
6/3/2020,Q2,5,E+F,Lo Wu,Arrival,0,0,0,0
6/3/2020,Q2,5,E+F,Lo Wu,Departure,0,0,0,0
6/3/2020,Q2,5,E+F,Lok Ma Chau Spur Line,Arrival,0,0,0,0
6/3/2020,Q2,5,E+F,Lok Ma Chau Spur Line,Departure,0,0,0,0
6/3/2020,Q2,5,E+F,Hong Kong-Zhuhai-Macao Bridge,Arrival,97,6,4,107
6/3/2020,Q2,5,E+F,Hong Kong-Zhuhai-Macao Bridge,Departure,64,0,2,66
6/3/2020,Q2,5,E+F,Lok Ma Chau,Arrival,0,0,0,0
6/3/2020,Q2,5,E+F,Lok Ma Chau,Departure,0,0,0,0
6/3/2020,Q2,5,E+F,Man Kam To,Arrival,0,0,0,0
6/3/2020,Q2,5,E+F,Man Kam To,Departure,0,0,0,0
6/3/2020,Q2,5,E+F,Sha Tau Kok,Arrival,0,0,0,0
6/3/2020,Q2,5,E+F,Sha Tau Kok,Departure,0,0,0,0
6/3/2020,Q2,5,E+F,Shenzhen Bay,Arrival,1147,196,6,1349
6/3/2020,Q2,5,E+F,Shenzhen Bay,Departure,609,88,2,699
6/3/2020,Q2,5,E+F,China Ferry Terminal,Arrival,0,0,0,0
6/3/2020,Q2,5,E+F,China Ferry Terminal,Departure,0,0,0,0
6/3/2020,Q2,5,E+F,Harbour Control,Arrival,0,0,0,0
6/3/2020,Q2,5,E+F,Harbour Control,Departure,0,0,0,0
6/3/2020,Q2,5,E+F,Kai Tak Cruise Terminal,Arrival,0,0,0,0
6/3/2020,Q2,5,E+F,Kai Tak Cruise Terminal,Departure,0,0,0,0
6/3/2020,Q2,5,E+F,Macau Ferry Terminal,Arrival,0,0,0,0
6/3/2020,Q2,5,E+F,Macau Ferry Terminal,Departure,0,0,0,0
6/3/2020,Q2,5,E+F,Tuen Mun Ferry Terminal,Arrival,0,0,0,0
6/3/2020,Q2,5,E+F,Tuen Mun Ferry Terminal,Departure,0,0,0,0
6/4/2020,Q2,5,E+F,Airport,Arrival,952,6,36,994
6/4/2020,Q2,5,E+F,Airport,Departure,440,5,80,525
6/4/2020,Q2,5,E+F,Express Rail Link West Kowloon,Arrival,0,0,0,0
6/4/2020,Q2,5,E+F,Express Rail Link West Kowloon,Departure,0,0,0,0
6/4/2020,Q2,5,E+F,Hung Hom,Arrival,0,0,0,0
6/4/2020,Q2,5,E+F,Hung Hom,Departure,0,0,0,0
6/4/2020,Q2,5,E+F,Lo Wu,Arrival,0,0,0,0
6/4/2020,Q2,5,E+F,Lo Wu,Departure,0,0,0,0
6/4/2020,Q2,5,E+F,Lok Ma Chau Spur Line,Arrival,0,0,0,0
6/4/2020,Q2,5,E+F,Lok Ma Chau Spur Line,Departure,0,0,0,0
6/4/2020,Q2,5,E+F,Hong Kong-Zhuhai-Macao Bridge,Arrival,78,11,10,99
6/4/2020,Q2,5,E+F,Hong Kong-Zhuhai-Macao Bridge,Departure,74,3,8,85
6/4/2020,Q2,5,E+F,Lok Ma Chau,Arrival,0,0,0,0
6/4/2020,Q2,5,E+F,Lok Ma Chau,Departure,0,0,0,0
6/4/2020,Q2,5,E+F,Man Kam To,Arrival,0,0,0,0
6/4/2020,Q2,5,E+F,Man Kam To,Departure,0,0,0,0
6/4/2020,Q2,5,E+F,Sha Tau Kok,Arrival,0,0,0,0
6/4/2020,Q2,5,E+F,Sha Tau Kok,Departure,0,0,0,0
6/4/2020,Q2,5,E+F,Shenzhen Bay,Arrival,1365,205,9,1579
6/4/2020,Q2,5,E+F,Shenzhen Bay,Departure,820,111,8,939
6/4/2020,Q2,5,E+F,China Ferry Terminal,Arrival,0,0,0,0
6/4/2020,Q2,5,E+F,China Ferry Terminal,Departure,0,0,0,0
6/4/2020,Q2,5,E+F,Harbour Control,Arrival,0,0,0,0
6/4/2020,Q2,5,E+F,Harbour Control,Departure,0,0,0,0
6/4/2020,Q2,5,E+F,Kai Tak Cruise Terminal,Arrival,0,0,0,0
6/4/2020,Q2,5,E+F,Kai Tak Cruise Terminal,Departure,0,0,0,0
6/4/2020,Q2,5,E+F,Macau Ferry Terminal,Arrival,0,0,0,0
6/4/2020,Q2,5,E+F,Macau Ferry Terminal,Departure,0,0,0,0
6/4/2020,Q2,5,E+F,Tuen Mun Ferry Terminal,Arrival,0,0,0,0
6/4/2020,Q2,5,E+F,Tuen Mun Ferry Terminal,Departure,0,0,0,0
6/5/2020,Q2,5,E+F,Airport,Arrival,1073,4,42,1119
6/5/2020,Q2,5,E+F,Airport,Departure,633,10,78,721
6/5/2020,Q2,5,E+F,Express Rail Link West Kowloon,Arrival,0,0,0,0
6/5/2020,Q2,5,E+F,Express Rail Link West Kowloon,Departure,0,0,0,0
6/5/2020,Q2,5,E+F,Hung Hom,Arrival,0,0,0,0
6/5/2020,Q2,5,E+F,Hung Hom,Departure,0,0,0,0
6/5/2020,Q2,5,E+F,Lo Wu,Arrival,0,0,0,0
6/5/2020,Q2,5,E+F,Lo Wu,Departure,0,0,0,0
6/5/2020,Q2,5,E+F,Lok Ma Chau Spur Line,Arrival,0,0,0,0
6/5/2020,Q2,5,E+F,Lok Ma Chau Spur Line,Departure,0,0,0,0
6/5/2020,Q2,5,E+F,Hong Kong-Zhuhai-Macao Bridge,Arrival,124,7,9,140
6/5/2020,Q2,5,E+F,Hong Kong-Zhuhai-Macao Bridge,Departure,65,9,3,77
6/5/2020,Q2,5,E+F,Lok Ma Chau,Arrival,0,0,0,0
6/5/2020,Q2,5,E+F,Lok Ma Chau,Departure,0,0,0,0
6/5/2020,Q2,5,E+F,Man Kam To,Arrival,0,0,0,0
6/5/2020,Q2,5,E+F,Man Kam To,Departure,0,0,0,0
6/5/2020,Q2,5,E+F,Sha Tau Kok,Arrival,0,0,0,0
6/5/2020,Q2,5,E+F,Sha Tau Kok,Departure,0,0,0,0
6/5/2020,Q2,5,E+F,Shenzhen Bay,Arrival,1378,223,13,1614
6/5/2020,Q2,5,E+F,Shenzhen Bay,Departure,829,120,14,963
6/5/2020,Q2,5,E+F,China Ferry Terminal,Arrival,0,0,0,0
6/5/2020,Q2,5,E+F,China Ferry Terminal,Departure,0,0,0,0
6/5/2020,Q2,5,E+F,Harbour Control,Arrival,0,0,0,0
6/5/2020,Q2,5,E+F,Harbour Control,Departure,0,0,0,0
6/5/2020,Q2,5,E+F,Kai Tak Cruise Terminal,Arrival,0,0,0,0
6/5/2020,Q2,5,E+F,Kai Tak Cruise Terminal,Departure,0,0,0,0
6/5/2020,Q2,5,E+F,Macau Ferry Terminal,Arrival,0,0,0,0
6/5/2020,Q2,5,E+F,Macau Ferry Terminal,Departure,0,0,0,0
6/5/2020,Q2,5,E+F,Tuen Mun Ferry Terminal,Arrival,0,0,0,0
6/5/2020,Q2,5,E+F,Tuen Mun Ferry Terminal,Departure,0,0,0,0
6/6/2020,Q2,5,E+F,Airport,Arrival,527,7,46,580
6/6/2020,Q2,5,E+F,Airport,Departure,390,22,186,598
6/6/2020,Q2,5,E+F,Express Rail Link West Kowloon,Arrival,0,0,0,0
6/6/2020,Q2,5,E+F,Express Rail Link West Kowloon,Departure,0,0,0,0
6/6/2020,Q2,5,E+F,Hung Hom,Arrival,0,0,0,0
6/6/2020,Q2,5,E+F,Hung Hom,Departure,0,0,0,0
6/6/2020,Q2,5,E+F,Lo Wu,Arrival,0,0,0,0
6/6/2020,Q2,5,E+F,Lo Wu,Departure,0,0,0,0
6/6/2020,Q2,5,E+F,Lok Ma Chau Spur Line,Arrival,0,0,0,0
6/6/2020,Q2,5,E+F,Lok Ma Chau Spur Line,Departure,0,0,0,0
6/6/2020,Q2,5,E+F,Hong Kong-Zhuhai-Macao Bridge,Arrival,115,14,4,133
6/6/2020,Q2,5,E+F,Hong Kong-Zhuhai-Macao Bridge,Departure,56,4,8,68
6/6/2020,Q2,5,E+F,Lok Ma Chau,Arrival,0,0,0,0
6/6/2020,Q2,5,E+F,Lok Ma Chau,Departure,0,0,0,0
6/6/2020,Q2,5,E+F,Man Kam To,Arrival,0,0,0,0
6/6/2020,Q2,5,E+F,Man Kam To,Departure,0,0,0,0
6/6/2020,Q2,5,E+F,Sha Tau Kok,Arrival,0,0,0,0
6/6/2020,Q2,5,E+F,Sha Tau Kok,Departure,0,0,0,0
6/6/2020,Q2,5,E+F,Shenzhen Bay,Arrival,1368,262,14,1644
6/6/2020,Q2,5,E+F,Shenzhen Bay,Departure,718,103,40,861
6/6/2020,Q2,5,E+F,China Ferry Terminal,Arrival,0,0,0,0
6/6/2020,Q2,5,E+F,China Ferry Terminal,Departure,0,0,0,0
6/6/2020,Q2,5,E+F,Harbour Control,Arrival,0,0,0,0
6/6/2020,Q2,5,E+F,Harbour Control,Departure,0,0,0,0
6/6/2020,Q2,5,E+F,Kai Tak Cruise Terminal,Arrival,0,0,0,0
6/6/2020,Q2,5,E+F,Kai Tak Cruise Terminal,Departure,0,0,0,0
6/6/2020,Q2,5,E+F,Macau Ferry Terminal,Arrival,0,0,0,0
6/6/2020,Q2,5,E+F,Macau Ferry Terminal,Departure,0,0,0,0
6/6/2020,Q2,5,E+F,Tuen Mun Ferry Terminal,Arrival,0,0,0,0
6/6/2020,Q2,5,E+F,Tuen Mun Ferry Terminal,Departure,0,0,0,0
6/7/2020,Q2,5,E+F,Airport,Arrival,1083,3,44,1130
6/7/2020,Q2,5,E+F,Airport,Departure,520,9,120,649
6/7/2020,Q2,5,E+F,Express Rail Link West Kowloon,Arrival,0,0,0,0
6/7/2020,Q2,5,E+F,Express Rail Link West Kowloon,Departure,0,0,0,0
6/7/2020,Q2,5,E+F,Hung Hom,Arrival,0,0,0,0
6/7/2020,Q2,5,E+F,Hung Hom,Departure,0,0,0,0
6/7/2020,Q2,5,E+F,Lo Wu,Arrival,0,0,0,0
6/7/2020,Q2,5,E+F,Lo Wu,Departure,0,0,0,0
6/7/2020,Q2,5,E+F,Lok Ma Chau Spur Line,Arrival,0,0,0,0
6/7/2020,Q2,5,E+F,Lok Ma Chau Spur Line,Departure,0,0,0,0
6/7/2020,Q2,5,E+F,Hong Kong-Zhuhai-Macao Bridge,Arrival,122,7,11,140
6/7/2020,Q2,5,E+F,Hong Kong-Zhuhai-Macao Bridge,Departure,56,3,4,63
6/7/2020,Q2,5,E+F,Lok Ma Chau,Arrival,0,0,0,0
6/7/2020,Q2,5,E+F,Lok Ma Chau,Departure,0,0,0,0
6/7/2020,Q2,5,E+F,Man Kam To,Arrival,0,0,0,0
6/7/2020,Q2,5,E+F,Man Kam To,Departure,0,0,0,0
6/7/2020,Q2,5,E+F,Sha Tau Kok,Arrival,0,0,0,0
6/7/2020,Q2,5,E+F,Sha Tau Kok,Departure,0,0,0,0
6/7/2020,Q2,5,E+F,Shenzhen Bay,Arrival,2123,366,16,2505
6/7/2020,Q2,5,E+F,Shenzhen Bay,Departure,670,133,3,806
6/7/2020,Q2,5,E+F,China Ferry Terminal,Arrival,0,0,0,0
6/7/2020,Q2,5,E+F,China Ferry Terminal,Departure,0,0,0,0
6/7/2020,Q2,5,E+F,Harbour Control,Arrival,0,0,0,0
6/7/2020,Q2,5,E+F,Harbour Control,Departure,0,0,0,0
6/7/2020,Q2,5,E+F,Kai Tak Cruise Terminal,Arrival,0,0,0,0
6/7/2020,Q2,5,E+F,Kai Tak Cruise Terminal,Departure,0,0,0,0
6/7/2020,Q2,5,E+F,Macau Ferry Terminal,Arrival,0,0,0,0
6/7/2020,Q2,5,E+F,Macau Ferry Terminal,Departure,0,0,0,0
6/7/2020,Q2,5,E+F,Tuen Mun Ferry Terminal,Arrival,0,0,0,0
6/7/2020,Q2,5,E+F,Tuen Mun Ferry Terminal,Departure,0,0,0,0
6/8/2020,Q2,5,E+F,Airport,Arrival,786,14,102,902
6/8/2020,Q2,5,E+F,Airport,Departure,235,17,44,296
6/8/2020,Q2,5,E+F,Express Rail Link West Kowloon,Arrival,0,0,0,0
6/8/2020,Q2,5,E+F,Express Rail Link West Kowloon,Departure,0,0,0,0
6/8/2020,Q2,5,E+F,Hung Hom,Arrival,0,0,0,0
6/8/2020,Q2,5,E+F,Hung Hom,Departure,0,0,0,0
6/8/2020,Q2,5,E+F,Lo Wu,Arrival,0,0,0,0
6/8/2020,Q2,5,E+F,Lo Wu,Departure,0,0,0,0
6/8/2020,Q2,5,E+F,Lok Ma Chau Spur Line,Arrival,0,0,0,0
6/8/2020,Q2,5,E+F,Lok Ma Chau Spur Line,Departure,0,0,0,0
6/8/2020,Q2,5,E+F,Hong Kong-Zhuhai-Macao Bridge,Arrival,152,11,10,173
6/8/2020,Q2,5,E+F,Hong Kong-Zhuhai-Macao Bridge,Departure,113,11,3,127
6/8/2020,Q2,5,E+F,Lok Ma Chau,Arrival,0,0,0,0
6/8/2020,Q2,5,E+F,Lok Ma Chau,Departure,0,0,0,0
6/8/2020,Q2,5,E+F,Man Kam To,Arrival,0,0,0,0
6/8/2020,Q2,5,E+F,Man Kam To,Departure,0,0,0,0
6/8/2020,Q2,5,E+F,Sha Tau Kok,Arrival,0,0,0,0
6/8/2020,Q2,5,E+F,Sha Tau Kok,Departure,0,0,0,0
6/8/2020,Q2,5,E+F,Shenzhen Bay,Arrival,2081,287,22,2390
6/8/2020,Q2,5,E+F,Shenzhen Bay,Departure,942,107,13,1062
6/8/2020,Q2,5,E+F,China Ferry Terminal,Arrival,0,0,0,0
6/8/2020,Q2,5,E+F,China Ferry Terminal,Departure,0,0,0,0
6/8/2020,Q2,5,E+F,Harbour Control,Arrival,0,0,0,0
6/8/2020,Q2,5,E+F,Harbour Control,Departure,0,0,0,0
6/8/2020,Q2,5,E+F,Kai Tak Cruise Terminal,Arrival,0,0,0,0
6/8/2020,Q2,5,E+F,Kai Tak Cruise Terminal,Departure,0,0,0,0
6/8/2020,Q2,5,E+F,Macau Ferry Terminal,Arrival,0,0,0,0
6/8/2020,Q2,5,E+F,Macau Ferry Terminal,Departure,0,0,0,0
6/8/2020,Q2,5,E+F,Tuen Mun Ferry Terminal,Arrival,0,0,0,0
6/8/2020,Q2,5,E+F,Tuen Mun Ferry Terminal,Departure,0,0,0,0
6/9/2020,Q2,5,E+F,Airport,Arrival,559,12,30,601
6/9/2020,Q2,5,E+F,Airport,Departure,374,22,44,440
6/9/2020,Q2,5,E+F,Express Rail Link West Kowloon,Arrival,0,0,0,0
6/9/2020,Q2,5,E+F,Express Rail Link West Kowloon,Departure,0,0,0,0
6/9/2020,Q2,5,E+F,Hung Hom,Arrival,0,0,0,0
6/9/2020,Q2,5,E+F,Hung Hom,Departure,0,0,0,0
6/9/2020,Q2,5,E+F,Lo Wu,Arrival,0,0,0,0
6/9/2020,Q2,5,E+F,Lo Wu,Departure,0,0,0,0
6/9/2020,Q2,5,E+F,Lok Ma Chau Spur Line,Arrival,0,0,0,0
6/9/2020,Q2,5,E+F,Lok Ma Chau Spur Line,Departure,0,0,0,0
6/9/2020,Q2,5,E+F,Hong Kong-Zhuhai-Macao Bridge,Arrival,99,6,8,113
6/9/2020,Q2,5,E+F,Hong Kong-Zhuhai-Macao Bridge,Departure,64,7,4,75
6/9/2020,Q2,5,E+F,Lok Ma Chau,Arrival,0,0,0,0
6/9/2020,Q2,5,E+F,Lok Ma Chau,Departure,0,0,0,0
6/9/2020,Q2,5,E+F,Man Kam To,Arrival,0,0,0,0
6/9/2020,Q2,5,E+F,Man Kam To,Departure,0,0,0,0
6/9/2020,Q2,5,E+F,Sha Tau Kok,Arrival,0,0,0,0
6/9/2020,Q2,5,E+F,Sha Tau Kok,Departure,0,0,0,0
6/9/2020,Q2,5,E+F,Shenzhen Bay,Arrival,1481,237,19,1737
6/9/2020,Q2,5,E+F,Shenzhen Bay,Departure,764,133,5,902
6/9/2020,Q2,5,E+F,China Ferry Terminal,Arrival,0,0,0,0
6/9/2020,Q2,5,E+F,China Ferry Terminal,Departure,0,0,0,0
6/9/2020,Q2,5,E+F,Harbour Control,Arrival,0,0,0,0
6/9/2020,Q2,5,E+F,Harbour Control,Departure,0,0,0,0
6/9/2020,Q2,5,E+F,Kai Tak Cruise Terminal,Arrival,0,0,0,0
6/9/2020,Q2,5,E+F,Kai Tak Cruise Terminal,Departure,0,0,0,0
6/9/2020,Q2,5,E+F,Macau Ferry Terminal,Arrival,0,0,0,0
6/9/2020,Q2,5,E+F,Macau Ferry Terminal,Departure,0,0,0,0
6/9/2020,Q2,5,E+F,Tuen Mun Ferry Terminal,Arrival,0,0,0,0
6/9/2020,Q2,5,E+F,Tuen Mun Ferry Terminal,Departure,0,0,0,0
6/10/2020,Q2,5,E+F,Airport,Arrival,570,3,15,588
6/10/2020,Q2,5,E+F,Airport,Departure,330,15,199,544
6/10/2020,Q2,5,E+F,Express Rail Link West Kowloon,Arrival,0,0,0,0
6/10/2020,Q2,5,E+F,Express Rail Link West Kowloon,Departure,0,0,0,0
6/10/2020,Q2,5,E+F,Hung Hom,Arrival,0,0,0,0
6/10/2020,Q2,5,E+F,Hung Hom,Departure,0,0,0,0
6/10/2020,Q2,5,E+F,Lo Wu,Arrival,0,0,0,0
6/10/2020,Q2,5,E+F,Lo Wu,Departure,0,0,0,0
6/10/2020,Q2,5,E+F,Lok Ma Chau Spur Line,Arrival,0,0,0,0
6/10/2020,Q2,5,E+F,Lok Ma Chau Spur Line,Departure,0,0,0,0
6/10/2020,Q2,5,E+F,Hong Kong-Zhuhai-Macao Bridge,Arrival,114,12,13,139
6/10/2020,Q2,5,E+F,Hong Kong-Zhuhai-Macao Bridge,Departure,61,3,1,65
6/10/2020,Q2,5,E+F,Lok Ma Chau,Arrival,0,0,0,0
6/10/2020,Q2,5,E+F,Lok Ma Chau,Departure,0,0,0,0
6/10/2020,Q2,5,E+F,Man Kam To,Arrival,0,0,0,0
6/10/2020,Q2,5,E+F,Man Kam To,Departure,0,0,0,0
6/10/2020,Q2,5,E+F,Sha Tau Kok,Arrival,0,0,0,0
6/10/2020,Q2,5,E+F,Sha Tau Kok,Departure,0,0,0,0
6/10/2020,Q2,5,E+F,Shenzhen Bay,Arrival,1520,251,18,1789
6/10/2020,Q2,5,E+F,Shenzhen Bay,Departure,714,106,4,824
6/10/2020,Q2,5,E+F,China Ferry Terminal,Arrival,0,0,0,0
6/10/2020,Q2,5,E+F,China Ferry Terminal,Departure,0,0,0,0
6/10/2020,Q2,5,E+F,Harbour Control,Arrival,0,0,0,0
6/10/2020,Q2,5,E+F,Harbour Control,Departure,0,0,0,0
6/10/2020,Q2,5,E+F,Kai Tak Cruise Terminal,Arrival,0,0,0,0
6/10/2020,Q2,5,E+F,Kai Tak Cruise Terminal,Departure,0,0,0,0
6/10/2020,Q2,5,E+F,Macau Ferry Terminal,Arrival,0,0,0,0
6/10/2020,Q2,5,E+F,Macau Ferry Terminal,Departure,0,0,0,0
6/10/2020,Q2,5,E+F,Tuen Mun Ferry Terminal,Arrival,0,0,0,0
6/10/2020,Q2,5,E+F,Tuen Mun Ferry Terminal,Departure,0,0,0,0
6/11/2020,Q2,5,E+F,Airport,Arrival,626,4,19,649
6/11/2020,Q2,5,E+F,Airport,Departure,341,10,36,387
6/11/2020,Q2,5,E+F,Express Rail Link West Kowloon,Arrival,0,0,0,0
6/11/2020,Q2,5,E+F,Express Rail Link West Kowloon,Departure,0,0,0,0
6/11/2020,Q2,5,E+F,Hung Hom,Arrival,0,0,0,0
6/11/2020,Q2,5,E+F,Hung Hom,Departure,0,0,0,0
6/11/2020,Q2,5,E+F,Lo Wu,Arrival,0,0,0,0
6/11/2020,Q2,5,E+F,Lo Wu,Departure,0,0,0,0
6/11/2020,Q2,5,E+F,Lok Ma Chau Spur Line,Arrival,0,0,0,0
6/11/2020,Q2,5,E+F,Lok Ma Chau Spur Line,Departure,0,0,0,0
6/11/2020,Q2,5,E+F,Hong Kong-Zhuhai-Macao Bridge,Arrival,83,7,5,95
6/11/2020,Q2,5,E+F,Hong Kong-Zhuhai-Macao Bridge,Departure,61,3,3,67
6/11/2020,Q2,5,E+F,Lok Ma Chau,Arrival,0,0,0,0
6/11/2020,Q2,5,E+F,Lok Ma Chau,Departure,0,0,0,0
6/11/2020,Q2,5,E+F,Man Kam To,Arrival,0,0,0,0
6/11/2020,Q2,5,E+F,Man Kam To,Departure,0,0,0,0
6/11/2020,Q2,5,E+F,Sha Tau Kok,Arrival,0,0,0,0
6/11/2020,Q2,5,E+F,Sha Tau Kok,Departure,0,0,0,0
6/11/2020,Q2,5,E+F,Shenzhen Bay,Arrival,1018,175,8,1201
6/11/2020,Q2,5,E+F,Shenzhen Bay,Departure,483,61,8,552
6/11/2020,Q2,5,E+F,China Ferry Terminal,Arrival,0,0,0,0
6/11/2020,Q2,5,E+F,China Ferry Terminal,Departure,0,0,0,0
6/11/2020,Q2,5,E+F,Harbour Control,Arrival,0,0,0,0
6/11/2020,Q2,5,E+F,Harbour Control,Departure,0,0,0,0
6/11/2020,Q2,5,E+F,Kai Tak Cruise Terminal,Arrival,0,0,0,0
6/11/2020,Q2,5,E+F,Kai Tak Cruise Terminal,Departure,0,0,0,0
6/11/2020,Q2,5,E+F,Macau Ferry Terminal,Arrival,0,0,0,0
6/11/2020,Q2,5,E+F,Macau Ferry Terminal,Departure,0,0,0,0
6/11/2020,Q2,5,E+F,Tuen Mun Ferry Terminal,Arrival,0,0,0,0
6/11/2020,Q2,5,E+F,Tuen Mun Ferry Terminal,Departure,0,0,0,0
6/12/2020,Q2,5,E+F,Airport,Arrival,1082,7,72,1161
6/12/2020,Q2,5,E+F,Airport,Departure,482,5,92,579
6/12/2020,Q2,5,E+F,Express Rail Link West Kowloon,Arrival,0,0,0,0
6/12/2020,Q2,5,E+F,Express Rail Link West Kowloon,Departure,0,0,0,0
6/12/2020,Q2,5,E+F,Hung Hom,Arrival,0,0,0,0
6/12/2020,Q2,5,E+F,Hung Hom,Departure,0,0,0,0
6/12/2020,Q2,5,E+F,Lo Wu,Arrival,0,0,0,0
6/12/2020,Q2,5,E+F,Lo Wu,Departure,0,0,0,0
6/12/2020,Q2,5,E+F,Lok Ma Chau Spur Line,Arrival,0,0,0,0
6/12/2020,Q2,5,E+F,Lok Ma Chau Spur Line,Departure,0,0,0,0
6/12/2020,Q2,5,E+F,Hong Kong-Zhuhai-Macao Bridge,Arrival,68,9,31,108
6/12/2020,Q2,5,E+F,Hong Kong-Zhuhai-Macao Bridge,Departure,48,2,4,54
6/12/2020,Q2,5,E+F,Lok Ma Chau,Arrival,0,0,0,0
6/12/2020,Q2,5,E+F,Lok Ma Chau,Departure,0,0,0,0
6/12/2020,Q2,5,E+F,Man Kam To,Arrival,0,0,0,0
6/12/2020,Q2,5,E+F,Man Kam To,Departure,0,0,0,0
6/12/2020,Q2,5,E+F,Sha Tau Kok,Arrival,0,0,0,0
6/12/2020,Q2,5,E+F,Sha Tau Kok,Departure,0,0,0,0
6/12/2020,Q2,5,E+F,Shenzhen Bay,Arrival,924,166,19,1109
6/12/2020,Q2,5,E+F,Shenzhen Bay,Departure,451,63,6,520
6/12/2020,Q2,5,E+F,China Ferry Terminal,Arrival,0,0,0,0
6/12/2020,Q2,5,E+F,China Ferry Terminal,Departure,0,0,0,0
6/12/2020,Q2,5,E+F,Harbour Control,Arrival,0,0,0,0
6/12/2020,Q2,5,E+F,Harbour Control,Departure,0,0,0,0
6/12/2020,Q2,5,E+F,Kai Tak Cruise Terminal,Arrival,0,0,0,0
6/12/2020,Q2,5,E+F,Kai Tak Cruise Terminal,Departure,0,0,0,0
6/12/2020,Q2,5,E+F,Macau Ferry Terminal,Arrival,0,0,0,0
6/12/2020,Q2,5,E+F,Macau Ferry Terminal,Departure,0,0,0,0
6/12/2020,Q2,5,E+F,Tuen Mun Ferry Terminal,Arrival,0,0,0,0
6/12/2020,Q2,5,E+F,Tuen Mun Ferry Terminal,Departure,0,0,0,0
6/13/2020,Q2,5,E+F,Airport,Arrival,732,4,54,790
6/13/2020,Q2,5,E+F,Airport,Departure,331,14,62,407
6/13/2020,Q2,5,E+F,Express Rail Link West Kowloon,Arrival,0,0,0,0
6/13/2020,Q2,5,E+F,Express Rail Link West Kowloon,Departure,0,0,0,0
6/13/2020,Q2,5,E+F,Hung Hom,Arrival,0,0,0,0
6/13/2020,Q2,5,E+F,Hung Hom,Departure,0,0,0,0
6/13/2020,Q2,5,E+F,Lo Wu,Arrival,0,0,0,0
6/13/2020,Q2,5,E+F,Lo Wu,Departure,0,0,0,0
6/13/2020,Q2,5,E+F,Lok Ma Chau Spur Line,Arrival,0,0,0,0
6/13/2020,Q2,5,E+F,Lok Ma Chau Spur Line,Departure,0,0,0,0
6/13/2020,Q2,5,E+F,Hong Kong-Zhuhai-Macao Bridge,Arrival,87,7,4,98
6/13/2020,Q2,5,E+F,Hong Kong-Zhuhai-Macao Bridge,Departure,50,3,4,57
6/13/2020,Q2,5,E+F,Lok Ma Chau,Arrival,0,0,0,0
6/13/2020,Q2,5,E+F,Lok Ma Chau,Departure,0,0,0,0
6/13/2020,Q2,5,E+F,Man Kam To,Arrival,0,0,0,0
6/13/2020,Q2,5,E+F,Man Kam To,Departure,0,0,0,0
6/13/2020,Q2,5,E+F,Sha Tau Kok,Arrival,0,0,0,0
6/13/2020,Q2,5,E+F,Sha Tau Kok,Departure,0,0,0,0
6/13/2020,Q2,5,E+F,Shenzhen Bay,Arrival,863,225,19,1107
6/13/2020,Q2,5,E+F,Shenzhen Bay,Departure,398,65,7,470
6/13/2020,Q2,5,E+F,China Ferry Terminal,Arrival,0,0,0,0
6/13/2020,Q2,5,E+F,China Ferry Terminal,Departure,0,0,0,0
6/13/2020,Q2,5,E+F,Harbour Control,Arrival,0,0,0,0
6/13/2020,Q2,5,E+F,Harbour Control,Departure,0,0,0,0
6/13/2020,Q2,5,E+F,Kai Tak Cruise Terminal,Arrival,0,0,0,0
6/13/2020,Q2,5,E+F,Kai Tak Cruise Terminal,Departure,0,0,0,0
6/13/2020,Q2,5,E+F,Macau Ferry Terminal,Arrival,0,0,0,0
6/13/2020,Q2,5,E+F,Macau Ferry Terminal,Departure,0,0,0,0
6/13/2020,Q2,5,E+F,Tuen Mun Ferry Terminal,Arrival,0,0,0,0
6/13/2020,Q2,5,E+F,Tuen Mun Ferry Terminal,Departure,0,0,0,0
6/14/2020,Q2,5,E+F,Airport,Arrival,970,3,50,1023
6/14/2020,Q2,5,E+F,Airport,Departure,550,16,80,646
6/14/2020,Q2,5,E+F,Express Rail Link West Kowloon,Arrival,0,0,0,0
6/14/2020,Q2,5,E+F,Express Rail Link West Kowloon,Departure,0,0,0,0
6/14/2020,Q2,5,E+F,Hung Hom,Arrival,0,0,0,0
6/14/2020,Q2,5,E+F,Hung Hom,Departure,0,0,0,0
6/14/2020,Q2,5,E+F,Lo Wu,Arrival,0,0,0,0
6/14/2020,Q2,5,E+F,Lo Wu,Departure,0,0,0,0
6/14/2020,Q2,5,E+F,Lok Ma Chau Spur Line,Arrival,0,0,0,0
6/14/2020,Q2,5,E+F,Lok Ma Chau Spur Line,Departure,0,0,0,0
6/14/2020,Q2,5,E+F,Hong Kong-Zhuhai-Macao Bridge,Arrival,30,4,3,37
6/14/2020,Q2,5,E+F,Hong Kong-Zhuhai-Macao Bridge,Departure,28,3,6,37
6/14/2020,Q2,5,E+F,Lok Ma Chau,Arrival,0,0,0,0
6/14/2020,Q2,5,E+F,Lok Ma Chau,Departure,0,0,0,0
6/14/2020,Q2,5,E+F,Man Kam To,Arrival,0,0,0,0
6/14/2020,Q2,5,E+F,Man Kam To,Departure,0,0,0,0
6/14/2020,Q2,5,E+F,Sha Tau Kok,Arrival,0,0,0,0
6/14/2020,Q2,5,E+F,Sha Tau Kok,Departure,0,0,0,0
6/14/2020,Q2,5,E+F,Shenzhen Bay,Arrival,651,149,14,814
6/14/2020,Q2,5,E+F,Shenzhen Bay,Departure,298,79,6,383
6/14/2020,Q2,5,E+F,China Ferry Terminal,Arrival,0,0,0,0
6/14/2020,Q2,5,E+F,China Ferry Terminal,Departure,0,0,0,0
6/14/2020,Q2,5,E+F,Harbour Control,Arrival,0,0,0,0
6/14/2020,Q2,5,E+F,Harbour Control,Departure,0,0,0,0
6/14/2020,Q2,5,E+F,Kai Tak Cruise Terminal,Arrival,0,0,0,0
6/14/2020,Q2,5,E+F,Kai Tak Cruise Terminal,Departure,0,0,0,0
6/14/2020,Q2,5,E+F,Macau Ferry Terminal,Arrival,0,0,0,0
6/14/2020,Q2,5,E+F,Macau Ferry Terminal,Departure,0,0,0,0
6/14/2020,Q2,5,E+F,Tuen Mun Ferry Terminal,Arrival,0,0,0,0
6/14/2020,Q2,5,E+F,Tuen Mun Ferry Terminal,Departure,0,0,0,0
6/15/2020,Q2,5,E+F,Airport,Arrival,877,7,75,959
6/15/2020,Q2,5,E+F,Airport,Departure,280,12,58,350
6/15/2020,Q2,5,E+F,Express Rail Link West Kowloon,Arrival,0,0,0,0
6/15/2020,Q2,5,E+F,Express Rail Link West Kowloon,Departure,0,0,0,0
6/15/2020,Q2,5,E+F,Hung Hom,Arrival,0,0,0,0
6/15/2020,Q2,5,E+F,Hung Hom,Departure,0,0,0,0
6/15/2020,Q2,5,E+F,Lo Wu,Arrival,0,0,0,0
6/15/2020,Q2,5,E+F,Lo Wu,Departure,0,0,0,0
6/15/2020,Q2,5,E+F,Lok Ma Chau Spur Line,Arrival,1297,0,0,1297
6/15/2020,Q2,5,E+F,Lok Ma Chau Spur Line,Departure,1297,0,0,1297
6/15/2020,Q2,5,E+F,Hong Kong-Zhuhai-Macao Bridge,Arrival,51,3,3,57
6/15/2020,Q2,5,E+F,Hong Kong-Zhuhai-Macao Bridge,Departure,63,1,5,69
6/15/2020,Q2,5,E+F,Lok Ma Chau,Arrival,0,0,0,0
6/15/2020,Q2,5,E+F,Lok Ma Chau,Departure,0,0,0,0
6/15/2020,Q2,5,E+F,Man Kam To,Arrival,0,0,0,0
6/15/2020,Q2,5,E+F,Man Kam To,Departure,0,0,0,0
6/15/2020,Q2,5,E+F,Sha Tau Kok,Arrival,0,0,0,0
6/15/2020,Q2,5,E+F,Sha Tau Kok,Departure,0,0,0,0
6/15/2020,Q2,5,E+F,Shenzhen Bay,Arrival,1259,160,18,1437
6/15/2020,Q2,5,E+F,Shenzhen Bay,Departure,858,74,23,955
6/15/2020,Q2,5,E+F,China Ferry Terminal,Arrival,0,0,0,0
6/15/2020,Q2,5,E+F,China Ferry Terminal,Departure,0,0,0,0
6/15/2020,Q2,5,E+F,Harbour Control,Arrival,0,0,0,0
6/15/2020,Q2,5,E+F,Harbour Control,Departure,0,0,0,0
6/15/2020,Q2,5,E+F,Kai Tak Cruise Terminal,Arrival,0,0,0,0
6/15/2020,Q2,5,E+F,Kai Tak Cruise Terminal,Departure,0,0,0,0
6/15/2020,Q2,5,E+F,Macau Ferry Terminal,Arrival,0,0,0,0
6/15/2020,Q2,5,E+F,Macau Ferry Terminal,Departure,0,0,0,0
6/15/2020,Q2,5,E+F,Tuen Mun Ferry Terminal,Arrival,0,0,0,0
6/15/2020,Q2,5,E+F,Tuen Mun Ferry Terminal,Departure,0,0,0,0
6/16/2020,Q2,5,E+F,Airport,Arrival,928,4,42,974
6/16/2020,Q2,5,E+F,Airport,Departure,477,19,51,547
6/16/2020,Q2,5,E+F,Express Rail Link West Kowloon,Arrival,0,0,0,0
6/16/2020,Q2,5,E+F,Express Rail Link West Kowloon,Departure,0,0,0,0
6/16/2020,Q2,5,E+F,Hung Hom,Arrival,0,0,0,0
6/16/2020,Q2,5,E+F,Hung Hom,Departure,0,0,0,0
6/16/2020,Q2,5,E+F,Lo Wu,Arrival,0,0,0,0
6/16/2020,Q2,5,E+F,Lo Wu,Departure,0,0,0,0
6/16/2020,Q2,5,E+F,Lok Ma Chau Spur Line,Arrival,1249,0,0,1249
6/16/2020,Q2,5,E+F,Lok Ma Chau Spur Line,Departure,1249,0,0,1249
6/16/2020,Q2,5,E+F,Hong Kong-Zhuhai-Macao Bridge,Arrival,55,1,9,65
6/16/2020,Q2,5,E+F,Hong Kong-Zhuhai-Macao Bridge,Departure,82,4,11,97
6/16/2020,Q2,5,E+F,Lok Ma Chau,Arrival,0,0,0,0
6/16/2020,Q2,5,E+F,Lok Ma Chau,Departure,0,0,0,0
6/16/2020,Q2,5,E+F,Man Kam To,Arrival,0,0,0,0
6/16/2020,Q2,5,E+F,Man Kam To,Departure,0,0,0,0
6/16/2020,Q2,5,E+F,Sha Tau Kok,Arrival,0,0,0,0
6/16/2020,Q2,5,E+F,Sha Tau Kok,Departure,0,0,0,0
6/16/2020,Q2,5,E+F,Shenzhen Bay,Arrival,1127,159,15,1301
6/16/2020,Q2,5,E+F,Shenzhen Bay,Departure,796,77,3,876
6/16/2020,Q2,5,E+F,China Ferry Terminal,Arrival,0,0,0,0
6/16/2020,Q2,5,E+F,China Ferry Terminal,Departure,0,0,0,0
6/16/2020,Q2,5,E+F,Harbour Control,Arrival,0,0,0,0
6/16/2020,Q2,5,E+F,Harbour Control,Departure,0,0,0,0
6/16/2020,Q2,5,E+F,Kai Tak Cruise Terminal,Arrival,0,0,0,0
6/16/2020,Q2,5,E+F,Kai Tak Cruise Terminal,Departure,0,0,0,0
6/16/2020,Q2,5,E+F,Macau Ferry Terminal,Arrival,0,0,0,0
6/16/2020,Q2,5,E+F,Macau Ferry Terminal,Departure,0,0,0,0
6/16/2020,Q2,5,E+F,Tuen Mun Ferry Terminal,Arrival,0,0,0,0
6/16/2020,Q2,5,E+F,Tuen Mun Ferry Terminal,Departure,0,0,0,0
6/17/2020,Q2,5,E+F,Airport,Arrival,846,11,40,897
6/17/2020,Q2,5,E+F,Airport,Departure,243,8,35,286
6/17/2020,Q2,5,E+F,Express Rail Link West Kowloon,Arrival,0,0,0,0
6/17/2020,Q2,5,E+F,Express Rail Link West Kowloon,Departure,0,0,0,0
6/17/2020,Q2,5,E+F,Hung Hom,Arrival,0,0,0,0
6/17/2020,Q2,5,E+F,Hung Hom,Departure,0,0,0,0
6/17/2020,Q2,5,E+F,Lo Wu,Arrival,0,0,0,0
6/17/2020,Q2,5,E+F,Lo Wu,Departure,0,0,0,0
6/17/2020,Q2,5,E+F,Lok Ma Chau Spur Line,Arrival,1272,0,0,1272
6/17/2020,Q2,5,E+F,Lok Ma Chau Spur Line,Departure,1272,0,0,1272
6/17/2020,Q2,5,E+F,Hong Kong-Zhuhai-Macao Bridge,Arrival,71,0,12,83
6/17/2020,Q2,5,E+F,Hong Kong-Zhuhai-Macao Bridge,Departure,75,6,1,82
6/17/2020,Q2,5,E+F,Lok Ma Chau,Arrival,0,0,0,0
6/17/2020,Q2,5,E+F,Lok Ma Chau,Departure,0,0,0,0
6/17/2020,Q2,5,E+F,Man Kam To,Arrival,0,0,0,0
6/17/2020,Q2,5,E+F,Man Kam To,Departure,0,0,0,0
6/17/2020,Q2,5,E+F,Sha Tau Kok,Arrival,0,0,0,0
6/17/2020,Q2,5,E+F,Sha Tau Kok,Departure,0,0,0,0
6/17/2020,Q2,5,E+F,Shenzhen Bay,Arrival,1074,137,17,1228
6/17/2020,Q2,5,E+F,Shenzhen Bay,Departure,796,112,2,910
6/17/2020,Q2,5,E+F,China Ferry Terminal,Arrival,0,0,0,0
6/17/2020,Q2,5,E+F,China Ferry Terminal,Departure,0,0,0,0
6/17/2020,Q2,5,E+F,Harbour Control,Arrival,0,0,0,0
6/17/2020,Q2,5,E+F,Harbour Control,Departure,0,0,0,0
6/17/2020,Q2,5,E+F,Kai Tak Cruise Terminal,Arrival,0,0,0,0
6/17/2020,Q2,5,E+F,Kai Tak Cruise Terminal,Departure,0,0,0,0
6/17/2020,Q2,5,E+F,Macau Ferry Terminal,Arrival,0,0,0,0
6/17/2020,Q2,5,E+F,Macau Ferry Terminal,Departure,0,0,0,0
6/17/2020,Q2,5,E+F,Tuen Mun Ferry Terminal,Arrival,0,0,0,0
6/17/2020,Q2,5,E+F,Tuen Mun Ferry Terminal,Departure,0,0,0,0
6/18/2020,Q2,5,E+F,Airport,Arrival,708,0,34,742
6/18/2020,Q2,5,E+F,Airport,Departure,438,6,95,539
6/18/2020,Q2,5,E+F,Express Rail Link West Kowloon,Arrival,0,0,0,0
6/18/2020,Q2,5,E+F,Express Rail Link West Kowloon,Departure,0,0,0,0
6/18/2020,Q2,5,E+F,Hung Hom,Arrival,0,0,0,0
6/18/2020,Q2,5,E+F,Hung Hom,Departure,0,0,0,0
6/18/2020,Q2,5,E+F,Lo Wu,Arrival,0,0,0,0
6/18/2020,Q2,5,E+F,Lo Wu,Departure,0,0,0,0
6/18/2020,Q2,5,E+F,Lok Ma Chau Spur Line,Arrival,1271,0,0,1271
6/18/2020,Q2,5,E+F,Lok Ma Chau Spur Line,Departure,1271,0,0,1271
6/18/2020,Q2,5,E+F,Hong Kong-Zhuhai-Macao Bridge,Arrival,56,3,4,63
6/18/2020,Q2,5,E+F,Hong Kong-Zhuhai-Macao Bridge,Departure,60,8,3,71
6/18/2020,Q2,5,E+F,Lok Ma Chau,Arrival,0,0,0,0
6/18/2020,Q2,5,E+F,Lok Ma Chau,Departure,0,0,0,0
6/18/2020,Q2,5,E+F,Man Kam To,Arrival,0,0,0,0
6/18/2020,Q2,5,E+F,Man Kam To,Departure,0,0,0,0
6/18/2020,Q2,5,E+F,Sha Tau Kok,Arrival,0,0,0,0
6/18/2020,Q2,5,E+F,Sha Tau Kok,Departure,0,0,0,0
6/18/2020,Q2,5,E+F,Shenzhen Bay,Arrival,1026,143,19,1188
6/18/2020,Q2,5,E+F,Shenzhen Bay,Departure,845,92,1,938
6/18/2020,Q2,5,E+F,China Ferry Terminal,Arrival,0,0,0,0
6/18/2020,Q2,5,E+F,China Ferry Terminal,Departure,0,0,0,0
6/18/2020,Q2,5,E+F,Harbour Control,Arrival,0,0,0,0
6/18/2020,Q2,5,E+F,Harbour Control,Departure,0,0,0,0
6/18/2020,Q2,5,E+F,Kai Tak Cruise Terminal,Arrival,0,0,0,0
6/18/2020,Q2,5,E+F,Kai Tak Cruise Terminal,Departure,0,0,0,0
6/18/2020,Q2,5,E+F,Macau Ferry Terminal,Arrival,0,0,0,0
6/18/2020,Q2,5,E+F,Macau Ferry Terminal,Departure,0,0,0,0
6/18/2020,Q2,5,E+F,Tuen Mun Ferry Terminal,Arrival,0,0,0,0
6/18/2020,Q2,5,E+F,Tuen Mun Ferry Terminal,Departure,0,0,0,0
6/19/2020,Q2,5,E+F,Airport,Arrival,1022,2,86,1110
6/19/2020,Q2,5,E+F,Airport,Departure,641,5,180,826
6/19/2020,Q2,5,E+F,Express Rail Link West Kowloon,Arrival,0,0,0,0
6/19/2020,Q2,5,E+F,Express Rail Link West Kowloon,Departure,0,0,0,0
6/19/2020,Q2,5,E+F,Hung Hom,Arrival,0,0,0,0
6/19/2020,Q2,5,E+F,Hung Hom,Departure,0,0,0,0
6/19/2020,Q2,5,E+F,Lo Wu,Arrival,0,0,0,0
6/19/2020,Q2,5,E+F,Lo Wu,Departure,0,0,0,0
6/19/2020,Q2,5,E+F,Lok Ma Chau Spur Line,Arrival,1147,0,0,1147
6/19/2020,Q2,5,E+F,Lok Ma Chau Spur Line,Departure,1146,0,0,1146
6/19/2020,Q2,5,E+F,Hong Kong-Zhuhai-Macao Bridge,Arrival,59,8,3,70
6/19/2020,Q2,5,E+F,Hong Kong-Zhuhai-Macao Bridge,Departure,71,1,8,80
6/19/2020,Q2,5,E+F,Lok Ma Chau,Arrival,0,0,0,0
6/19/2020,Q2,5,E+F,Lok Ma Chau,Departure,0,0,0,0
6/19/2020,Q2,5,E+F,Man Kam To,Arrival,0,0,0,0
6/19/2020,Q2,5,E+F,Man Kam To,Departure,0,0,0,0
6/19/2020,Q2,5,E+F,Sha Tau Kok,Arrival,0,0,0,0
6/19/2020,Q2,5,E+F,Sha Tau Kok,Departure,0,0,0,0
6/19/2020,Q2,5,E+F,Shenzhen Bay,Arrival,1000,110,10,1120
6/19/2020,Q2,5,E+F,Shenzhen Bay,Departure,741,75,13,829
6/19/2020,Q2,5,E+F,China Ferry Terminal,Arrival,0,0,0,0
6/19/2020,Q2,5,E+F,China Ferry Terminal,Departure,0,0,0,0
6/19/2020,Q2,5,E+F,Harbour Control,Arrival,0,0,0,0
6/19/2020,Q2,5,E+F,Harbour Control,Departure,0,0,0,0
6/19/2020,Q2,5,E+F,Kai Tak Cruise Terminal,Arrival,0,0,0,0
6/19/2020,Q2,5,E+F,Kai Tak Cruise Terminal,Departure,0,0,0,0
6/19/2020,Q2,5,E+F,Macau Ferry Terminal,Arrival,0,0,0,0
6/19/2020,Q2,5,E+F,Macau Ferry Terminal,Departure,0,0,0,0
6/19/2020,Q2,5,E+F,Tuen Mun Ferry Terminal,Arrival,0,0,0,0
6/19/2020,Q2,5,E+F,Tuen Mun Ferry Terminal,Departure,0,0,0,0
6/20/2020,Q2,5,E+F,Airport,Arrival,972,12,54,1038
6/20/2020,Q2,5,E+F,Airport,Departure,392,5,51,448
6/20/2020,Q2,5,E+F,Express Rail Link West Kowloon,Arrival,0,0,0,0
6/20/2020,Q2,5,E+F,Express Rail Link West Kowloon,Departure,0,0,0,0
6/20/2020,Q2,5,E+F,Hung Hom,Arrival,0,0,0,0
6/20/2020,Q2,5,E+F,Hung Hom,Departure,0,0,0,0
6/20/2020,Q2,5,E+F,Lo Wu,Arrival,0,0,0,0
6/20/2020,Q2,5,E+F,Lo Wu,Departure,0,0,0,0
6/20/2020,Q2,5,E+F,Lok Ma Chau Spur Line,Arrival,0,0,0,0
6/20/2020,Q2,5,E+F,Lok Ma Chau Spur Line,Departure,0,0,0,0
6/20/2020,Q2,5,E+F,Hong Kong-Zhuhai-Macao Bridge,Arrival,46,5,8,59
6/20/2020,Q2,5,E+F,Hong Kong-Zhuhai-Macao Bridge,Departure,54,4,6,64
6/20/2020,Q2,5,E+F,Lok Ma Chau,Arrival,0,0,0,0
6/20/2020,Q2,5,E+F,Lok Ma Chau,Departure,0,0,0,0
6/20/2020,Q2,5,E+F,Man Kam To,Arrival,0,0,0,0
6/20/2020,Q2,5,E+F,Man Kam To,Departure,0,0,0,0
6/20/2020,Q2,5,E+F,Sha Tau Kok,Arrival,0,0,0,0
6/20/2020,Q2,5,E+F,Sha Tau Kok,Departure,0,0,0,0
6/20/2020,Q2,5,E+F,Shenzhen Bay,Arrival,728,154,21,903
6/20/2020,Q2,5,E+F,Shenzhen Bay,Departure,444,85,5,534
6/20/2020,Q2,5,E+F,China Ferry Terminal,Arrival,0,0,0,0
6/20/2020,Q2,5,E+F,China Ferry Terminal,Departure,0,0,0,0
6/20/2020,Q2,5,E+F,Harbour Control,Arrival,0,0,0,0
6/20/2020,Q2,5,E+F,Harbour Control,Departure,0,0,0,0
6/20/2020,Q2,5,E+F,Kai Tak Cruise Terminal,Arrival,0,0,0,0
6/20/2020,Q2,5,E+F,Kai Tak Cruise Terminal,Departure,0,0,0,0
6/20/2020,Q2,5,E+F,Macau Ferry Terminal,Arrival,0,0,0,0
6/20/2020,Q2,5,E+F,Macau Ferry Terminal,Departure,0,0,0,0
6/20/2020,Q2,5,E+F,Tuen Mun Ferry Terminal,Arrival,0,0,0,0
6/20/2020,Q2,5,E+F,Tuen Mun Ferry Terminal,Departure,0,0,0,0
6/21/2020,Q2,5,E+F,Airport,Arrival,1385,5,71,1461
6/21/2020,Q2,5,E+F,Airport,Departure,742,27,78,847
6/21/2020,Q2,5,E+F,Express Rail Link West Kowloon,Arrival,0,0,0,0
6/21/2020,Q2,5,E+F,Express Rail Link West Kowloon,Departure,0,0,0,0
6/21/2020,Q2,5,E+F,Hung Hom,Arrival,0,0,0,0
6/21/2020,Q2,5,E+F,Hung Hom,Departure,0,0,0,0
6/21/2020,Q2,5,E+F,Lo Wu,Arrival,0,0,0,0
6/21/2020,Q2,5,E+F,Lo Wu,Departure,0,0,0,0
6/21/2020,Q2,5,E+F,Lok Ma Chau Spur Line,Arrival,0,0,0,0
6/21/2020,Q2,5,E+F,Lok Ma Chau Spur Line,Departure,0,0,0,0
6/21/2020,Q2,5,E+F,Hong Kong-Zhuhai-Macao Bridge,Arrival,52,0,1,53
6/21/2020,Q2,5,E+F,Hong Kong-Zhuhai-Macao Bridge,Departure,38,3,2,43
6/21/2020,Q2,5,E+F,Lok Ma Chau,Arrival,0,0,0,0
6/21/2020,Q2,5,E+F,Lok Ma Chau,Departure,0,0,0,0
6/21/2020,Q2,5,E+F,Man Kam To,Arrival,0,0,0,0
6/21/2020,Q2,5,E+F,Man Kam To,Departure,0,0,0,0
6/21/2020,Q2,5,E+F,Sha Tau Kok,Arrival,0,0,0,0
6/21/2020,Q2,5,E+F,Sha Tau Kok,Departure,0,0,0,0
6/21/2020,Q2,5,E+F,Shenzhen Bay,Arrival,623,141,17,781
6/21/2020,Q2,5,E+F,Shenzhen Bay,Departure,399,77,5,481
6/21/2020,Q2,5,E+F,China Ferry Terminal,Arrival,0,0,0,0
6/21/2020,Q2,5,E+F,China Ferry Terminal,Departure,0,0,0,0
6/21/2020,Q2,5,E+F,Harbour Control,Arrival,0,0,0,0
6/21/2020,Q2,5,E+F,Harbour Control,Departure,0,0,0,0
6/21/2020,Q2,5,E+F,Kai Tak Cruise Terminal,Arrival,0,0,0,0
6/21/2020,Q2,5,E+F,Kai Tak Cruise Terminal,Departure,0,0,0,0
6/21/2020,Q2,5,E+F,Macau Ferry Terminal,Arrival,0,0,0,0
6/21/2020,Q2,5,E+F,Macau Ferry Terminal,Departure,0,0,0,0
6/21/2020,Q2,5,E+F,Tuen Mun Ferry Terminal,Arrival,0,0,0,0
6/21/2020,Q2,5,E+F,Tuen Mun Ferry Terminal,Departure,0,0,0,0
6/22/2020,Q2,5,E+F,Airport,Arrival,592,7,64,663
6/22/2020,Q2,5,E+F,Airport,Departure,211,4,36,251
6/22/2020,Q2,5,E+F,Express Rail Link West Kowloon,Arrival,0,0,0,0
6/22/2020,Q2,5,E+F,Express Rail Link West Kowloon,Departure,0,0,0,0
6/22/2020,Q2,5,E+F,Hung Hom,Arrival,0,0,0,0
6/22/2020,Q2,5,E+F,Hung Hom,Departure,0,0,0,0
6/22/2020,Q2,5,E+F,Lo Wu,Arrival,0,0,0,0
6/22/2020,Q2,5,E+F,Lo Wu,Departure,0,0,0,0
6/22/2020,Q2,5,E+F,Lok Ma Chau Spur Line,Arrival,1285,0,0,1285
6/22/2020,Q2,5,E+F,Lok Ma Chau Spur Line,Departure,1285,0,0,1285
6/22/2020,Q2,5,E+F,Hong Kong-Zhuhai-Macao Bridge,Arrival,54,4,2,60
6/22/2020,Q2,5,E+F,Hong Kong-Zhuhai-Macao Bridge,Departure,86,5,14,105
6/22/2020,Q2,5,E+F,Lok Ma Chau,Arrival,0,0,0,0
6/22/2020,Q2,5,E+F,Lok Ma Chau,Departure,0,0,0,0
6/22/2020,Q2,5,E+F,Man Kam To,Arrival,0,0,0,0
6/22/2020,Q2,5,E+F,Man Kam To,Departure,0,0,0,0
6/22/2020,Q2,5,E+F,Sha Tau Kok,Arrival,0,0,0,0
6/22/2020,Q2,5,E+F,Sha Tau Kok,Departure,0,0,0,0
6/22/2020,Q2,5,E+F,Shenzhen Bay,Arrival,1048,168,18,1234
6/22/2020,Q2,5,E+F,Shenzhen Bay,Departure,998,74,31,1103
6/22/2020,Q2,5,E+F,China Ferry Terminal,Arrival,0,0,0,0
6/22/2020,Q2,5,E+F,China Ferry Terminal,Departure,0,0,0,0
6/22/2020,Q2,5,E+F,Harbour Control,Arrival,0,0,0,0
6/22/2020,Q2,5,E+F,Harbour Control,Departure,0,0,0,0
6/22/2020,Q2,5,E+F,Kai Tak Cruise Terminal,Arrival,0,0,0,0
6/22/2020,Q2,5,E+F,Kai Tak Cruise Terminal,Departure,0,0,0,0
6/22/2020,Q2,5,E+F,Macau Ferry Terminal,Arrival,0,0,0,0
6/22/2020,Q2,5,E+F,Macau Ferry Terminal,Departure,0,0,0,0
6/22/2020,Q2,5,E+F,Tuen Mun Ferry Terminal,Arrival,0,0,0,0
6/22/2020,Q2,5,E+F,Tuen Mun Ferry Terminal,Departure,0,0,0,0
6/23/2020,Q2,5,E+F,Airport,Arrival,1179,9,34,1222
6/23/2020,Q2,5,E+F,Airport,Departure,429,18,54,501
6/23/2020,Q2,5,E+F,Express Rail Link West Kowloon,Arrival,0,0,0,0
6/23/2020,Q2,5,E+F,Express Rail Link West Kowloon,Departure,0,0,0,0
6/23/2020,Q2,5,E+F,Hung Hom,Arrival,0,0,0,0
6/23/2020,Q2,5,E+F,Hung Hom,Departure,0,0,0,0
6/23/2020,Q2,5,E+F,Lo Wu,Arrival,0,0,0,0
6/23/2020,Q2,5,E+F,Lo Wu,Departure,0,0,0,0
6/23/2020,Q2,5,E+F,Lok Ma Chau Spur Line,Arrival,1299,0,0,1299
6/23/2020,Q2,5,E+F,Lok Ma Chau Spur Line,Departure,1299,0,0,1299
6/23/2020,Q2,5,E+F,Hong Kong-Zhuhai-Macao Bridge,Arrival,48,2,3,53
6/23/2020,Q2,5,E+F,Hong Kong-Zhuhai-Macao Bridge,Departure,58,3,4,65
6/23/2020,Q2,5,E+F,Lok Ma Chau,Arrival,0,0,0,0
6/23/2020,Q2,5,E+F,Lok Ma Chau,Departure,0,0,0,0
6/23/2020,Q2,5,E+F,Man Kam To,Arrival,0,0,0,0
6/23/2020,Q2,5,E+F,Man Kam To,Departure,0,0,0,0
6/23/2020,Q2,5,E+F,Sha Tau Kok,Arrival,0,0,0,0
6/23/2020,Q2,5,E+F,Sha Tau Kok,Departure,0,0,0,0
6/23/2020,Q2,5,E+F,Shenzhen Bay,Arrival,973,136,9,1118
6/23/2020,Q2,5,E+F,Shenzhen Bay,Departure,778,73,6,857
6/23/2020,Q2,5,E+F,China Ferry Terminal,Arrival,0,0,0,0
6/23/2020,Q2,5,E+F,China Ferry Terminal,Departure,0,0,0,0
6/23/2020,Q2,5,E+F,Harbour Control,Arrival,0,0,0,0
6/23/2020,Q2,5,E+F,Harbour Control,Departure,0,0,0,0
6/23/2020,Q2,5,E+F,Kai Tak Cruise Terminal,Arrival,0,0,0,0
6/23/2020,Q2,5,E+F,Kai Tak Cruise Terminal,Departure,0,0,0,0
6/23/2020,Q2,5,E+F,Macau Ferry Terminal,Arrival,0,0,0,0
6/23/2020,Q2,5,E+F,Macau Ferry Terminal,Departure,0,0,0,0
6/23/2020,Q2,5,E+F,Tuen Mun Ferry Terminal,Arrival,0,0,0,0
6/23/2020,Q2,5,E+F,Tuen Mun Ferry Terminal,Departure,0,0,0,0
6/24/2020,Q2,5,E+F,Airport,Arrival,738,3,55,796
6/24/2020,Q2,5,E+F,Airport,Departure,547,6,44,597
6/24/2020,Q2,5,E+F,Express Rail Link West Kowloon,Arrival,0,0,0,0
6/24/2020,Q2,5,E+F,Express Rail Link West Kowloon,Departure,0,0,0,0
6/24/2020,Q2,5,E+F,Hung Hom,Arrival,0,0,0,0
6/24/2020,Q2,5,E+F,Hung Hom,Departure,0,0,0,0
6/24/2020,Q2,5,E+F,Lo Wu,Arrival,0,0,0,0
6/24/2020,Q2,5,E+F,Lo Wu,Departure,0,0,0,0
6/24/2020,Q2,5,E+F,Lok Ma Chau Spur Line,Arrival,1292,0,0,1292
6/24/2020,Q2,5,E+F,Lok Ma Chau Spur Line,Departure,1293,0,0,1293
6/24/2020,Q2,5,E+F,Hong Kong-Zhuhai-Macao Bridge,Arrival,52,2,3,57
6/24/2020,Q2,5,E+F,Hong Kong-Zhuhai-Macao Bridge,Departure,67,5,4,76
6/24/2020,Q2,5,E+F,Lok Ma Chau,Arrival,0,0,0,0
6/24/2020,Q2,5,E+F,Lok Ma Chau,Departure,0,0,0,0
6/24/2020,Q2,5,E+F,Man Kam To,Arrival,0,0,0,0
6/24/2020,Q2,5,E+F,Man Kam To,Departure,0,0,0,0
6/24/2020,Q2,5,E+F,Sha Tau Kok,Arrival,0,0,0,0
6/24/2020,Q2,5,E+F,Sha Tau Kok,Departure,0,0,0,0
6/24/2020,Q2,5,E+F,Shenzhen Bay,Arrival,1019,99,15,1133
6/24/2020,Q2,5,E+F,Shenzhen Bay,Departure,796,72,4,872
6/24/2020,Q2,5,E+F,China Ferry Terminal,Arrival,0,0,0,0
6/24/2020,Q2,5,E+F,China Ferry Terminal,Departure,0,0,0,0
6/24/2020,Q2,5,E+F,Harbour Control,Arrival,0,0,0,0
6/24/2020,Q2,5,E+F,Harbour Control,Departure,0,0,0,0
6/24/2020,Q2,5,E+F,Kai Tak Cruise Terminal,Arrival,0,0,0,0
6/24/2020,Q2,5,E+F,Kai Tak Cruise Terminal,Departure,0,0,0,0
6/24/2020,Q2,5,E+F,Macau Ferry Terminal,Arrival,0,0,0,0
6/24/2020,Q2,5,E+F,Macau Ferry Terminal,Departure,0,0,0,0
6/24/2020,Q2,5,E+F,Tuen Mun Ferry Terminal,Arrival,0,0,0,0
6/24/2020,Q2,5,E+F,Tuen Mun Ferry Terminal,Departure,0,0,0,0
6/25/2020,Q2,5,G,Airport,Arrival,815,2,46,863
6/25/2020,Q2,5,G,Airport,Departure,716,11,68,795
6/25/2020,Q2,5,G,Express Rail Link West Kowloon,Arrival,0,0,0,0
6/25/2020,Q2,5,G,Express Rail Link West Kowloon,Departure,0,0,0,0
6/25/2020,Q2,5,G,Hung Hom,Arrival,0,0,0,0
6/25/2020,Q2,5,G,Hung Hom,Departure,0,0,0,0
6/25/2020,Q2,5,G,Lo Wu,Arrival,0,0,0,0
6/25/2020,Q2,5,G,Lo Wu,Departure,0,0,0,0
6/25/2020,Q2,5,G,Lok Ma Chau Spur Line,Arrival,0,0,0,0
6/25/2020,Q2,5,G,Lok Ma Chau Spur Line,Departure,0,0,0,0
6/25/2020,Q2,5,G,Hong Kong-Zhuhai-Macao Bridge,Arrival,49,2,1,52
6/25/2020,Q2,5,G,Hong Kong-Zhuhai-Macao Bridge,Departure,57,3,3,63
6/25/2020,Q2,5,G,Lok Ma Chau,Arrival,0,0,0,0
6/25/2020,Q2,5,G,Lok Ma Chau,Departure,0,0,0,0
6/25/2020,Q2,5,G,Man Kam To,Arrival,0,0,0,0
6/25/2020,Q2,5,G,Man Kam To,Departure,0,0,0,0
6/25/2020,Q2,5,G,Sha Tau Kok,Arrival,0,0,0,0
6/25/2020,Q2,5,G,Sha Tau Kok,Departure,0,0,0,0
6/25/2020,Q2,5,G,Shenzhen Bay,Arrival,501,93,9,603
6/25/2020,Q2,5,G,Shenzhen Bay,Departure,383,56,0,439
6/25/2020,Q2,5,G,China Ferry Terminal,Arrival,0,0,0,0
6/25/2020,Q2,5,G,China Ferry Terminal,Departure,0,0,0,0
6/25/2020,Q2,5,G,Harbour Control,Arrival,0,0,0,0
6/25/2020,Q2,5,G,Harbour Control,Departure,0,0,0,0
6/25/2020,Q2,5,G,Kai Tak Cruise Terminal,Arrival,0,0,0,0
6/25/2020,Q2,5,G,Kai Tak Cruise Terminal,Departure,0,0,0,0
6/25/2020,Q2,5,G,Macau Ferry Terminal,Arrival,0,0,0,0
6/25/2020,Q2,5,G,Macau Ferry Terminal,Departure,0,0,0,0
6/25/2020,Q2,5,G,Tuen Mun Ferry Terminal,Arrival,0,0,0,0
6/25/2020,Q2,5,G,Tuen Mun Ferry Terminal,Departure,0,0,0,0
6/26/2020,Q2,5,G,Airport,Arrival,1077,8,57,1142
6/26/2020,Q2,5,G,Airport,Departure,640,13,85,738
6/26/2020,Q2,5,G,Express Rail Link West Kowloon,Arrival,0,0,0,0
6/26/2020,Q2,5,G,Express Rail Link West Kowloon,Departure,0,0,0,0
6/26/2020,Q2,5,G,Hung Hom,Arrival,0,0,0,0
6/26/2020,Q2,5,G,Hung Hom,Departure,0,0,0,0
6/26/2020,Q2,5,G,Lo Wu,Arrival,0,0,0,0
6/26/2020,Q2,5,G,Lo Wu,Departure,0,0,0,0
6/26/2020,Q2,5,G,Lok Ma Chau Spur Line,Arrival,1264,0,0,1264
6/26/2020,Q2,5,G,Lok Ma Chau Spur Line,Departure,1264,0,0,1264
6/26/2020,Q2,5,G,Hong Kong-Zhuhai-Macao Bridge,Arrival,40,3,6,49
6/26/2020,Q2,5,G,Hong Kong-Zhuhai-Macao Bridge,Departure,58,7,2,67
6/26/2020,Q2,5,G,Lok Ma Chau,Arrival,0,0,0,0
6/26/2020,Q2,5,G,Lok Ma Chau,Departure,0,0,0,0
6/26/2020,Q2,5,G,Man Kam To,Arrival,0,0,0,0
6/26/2020,Q2,5,G,Man Kam To,Departure,0,0,0,0
6/26/2020,Q2,5,G,Sha Tau Kok,Arrival,0,0,0,0
6/26/2020,Q2,5,G,Sha Tau Kok,Departure,0,0,0,0
6/26/2020,Q2,5,G,Shenzhen Bay,Arrival,813,99,17,929
6/26/2020,Q2,5,G,Shenzhen Bay,Departure,732,76,2,810
6/26/2020,Q2,5,G,China Ferry Terminal,Arrival,0,0,0,0
6/26/2020,Q2,5,G,China Ferry Terminal,Departure,0,0,0,0
6/26/2020,Q2,5,G,Harbour Control,Arrival,0,0,0,0
6/26/2020,Q2,5,G,Harbour Control,Departure,0,0,0,0
6/26/2020,Q2,5,G,Kai Tak Cruise Terminal,Arrival,0,0,0,0
6/26/2020,Q2,5,G,Kai Tak Cruise Terminal,Departure,0,0,0,0
6/26/2020,Q2,5,G,Macau Ferry Terminal,Arrival,0,0,0,0
6/26/2020,Q2,5,G,Macau Ferry Terminal,Departure,0,0,0,0
6/26/2020,Q2,5,G,Tuen Mun Ferry Terminal,Arrival,0,0,0,0
6/26/2020,Q2,5,G,Tuen Mun Ferry Terminal,Departure,0,0,0,0
6/27/2020,Q2,5,G,Airport,Arrival,1024,1,53,1078
6/27/2020,Q2,5,G,Airport,Departure,625,15,138,778
6/27/2020,Q2,5,G,Express Rail Link West Kowloon,Arrival,0,0,0,0
6/27/2020,Q2,5,G,Express Rail Link West Kowloon,Departure,0,0,0,0
6/27/2020,Q2,5,G,Hung Hom,Arrival,0,0,0,0
6/27/2020,Q2,5,G,Hung Hom,Departure,0,0,0,0
6/27/2020,Q2,5,G,Lo Wu,Arrival,0,0,0,0
6/27/2020,Q2,5,G,Lo Wu,Departure,0,0,0,0
6/27/2020,Q2,5,G,Lok Ma Chau Spur Line,Arrival,0,0,0,0
6/27/2020,Q2,5,G,Lok Ma Chau Spur Line,Departure,0,0,0,0
6/27/2020,Q2,5,G,Hong Kong-Zhuhai-Macao Bridge,Arrival,37,7,10,54
6/27/2020,Q2,5,G,Hong Kong-Zhuhai-Macao Bridge,Departure,42,2,3,47
6/27/2020,Q2,5,G,Lok Ma Chau,Arrival,0,0,0,0
6/27/2020,Q2,5,G,Lok Ma Chau,Departure,0,0,0,0
6/27/2020,Q2,5,G,Man Kam To,Arrival,0,0,0,0
6/27/2020,Q2,5,G,Man Kam To,Departure,0,0,0,0
6/27/2020,Q2,5,G,Sha Tau Kok,Arrival,0,0,0,0
6/27/2020,Q2,5,G,Sha Tau Kok,Departure,0,0,0,0
6/27/2020,Q2,5,G,Shenzhen Bay,Arrival,527,73,12,612
6/27/2020,Q2,5,G,Shenzhen Bay,Departure,339,69,7,415
6/27/2020,Q2,5,G,China Ferry Terminal,Arrival,0,0,0,0
6/27/2020,Q2,5,G,China Ferry Terminal,Departure,0,0,0,0
6/27/2020,Q2,5,G,Harbour Control,Arrival,0,0,0,0
6/27/2020,Q2,5,G,Harbour Control,Departure,0,0,0,0
6/27/2020,Q2,5,G,Kai Tak Cruise Terminal,Arrival,0,0,0,0
6/27/2020,Q2,5,G,Kai Tak Cruise Terminal,Departure,0,0,0,0
6/27/2020,Q2,5,G,Macau Ferry Terminal,Arrival,0,0,0,0
6/27/2020,Q2,5,G,Macau Ferry Terminal,Departure,0,0,0,0
6/27/2020,Q2,5,G,Tuen Mun Ferry Terminal,Arrival,0,0,0,0
6/27/2020,Q2,5,G,Tuen Mun Ferry Terminal,Departure,0,0,0,0
6/28/2020,Q2,5,G,Airport,Arrival,928,5,69,1002
6/28/2020,Q2,5,G,Airport,Departure,874,1,103,978
6/28/2020,Q2,5,G,Express Rail Link West Kowloon,Arrival,0,0,0,0
6/28/2020,Q2,5,G,Express Rail Link West Kowloon,Departure,0,0,0,0
6/28/2020,Q2,5,G,Hung Hom,Arrival,0,0,0,0
6/28/2020,Q2,5,G,Hung Hom,Departure,0,0,0,0
6/28/2020,Q2,5,G,Lo Wu,Arrival,0,0,0,0
6/28/2020,Q2,5,G,Lo Wu,Departure,0,0,0,0
6/28/2020,Q2,5,G,Lok Ma Chau Spur Line,Arrival,0,0,0,0
6/28/2020,Q2,5,G,Lok Ma Chau Spur Line,Departure,0,0,0,0
6/28/2020,Q2,5,G,Hong Kong-Zhuhai-Macao Bridge,Arrival,31,2,2,35
6/28/2020,Q2,5,G,Hong Kong-Zhuhai-Macao Bridge,Departure,39,0,3,42
6/28/2020,Q2,5,G,Lok Ma Chau,Arrival,0,0,0,0
6/28/2020,Q2,5,G,Lok Ma Chau,Departure,0,0,0,0
6/28/2020,Q2,5,G,Man Kam To,Arrival,0,0,0,0
6/28/2020,Q2,5,G,Man Kam To,Departure,0,0,0,0
6/28/2020,Q2,5,G,Sha Tau Kok,Arrival,0,0,0,0
6/28/2020,Q2,5,G,Sha Tau Kok,Departure,0,0,0,0
6/28/2020,Q2,5,G,Shenzhen Bay,Arrival,608,117,11,736
6/28/2020,Q2,5,G,Shenzhen Bay,Departure,309,42,19,370
6/28/2020,Q2,5,G,China Ferry Terminal,Arrival,0,0,0,0
6/28/2020,Q2,5,G,China Ferry Terminal,Departure,0,0,0,0
6/28/2020,Q2,5,G,Harbour Control,Arrival,0,0,0,0
6/28/2020,Q2,5,G,Harbour Control,Departure,0,0,0,0
6/28/2020,Q2,5,G,Kai Tak Cruise Terminal,Arrival,0,0,0,0
6/28/2020,Q2,5,G,Kai Tak Cruise Terminal,Departure,0,0,0,0
6/28/2020,Q2,5,G,Macau Ferry Terminal,Arrival,0,0,0,0
6/28/2020,Q2,5,G,Macau Ferry Terminal,Departure,0,0,0,0
6/28/2020,Q2,5,G,Tuen Mun Ferry Terminal,Arrival,0,0,0,0
6/28/2020,Q2,5,G,Tuen Mun Ferry Terminal,Departure,0,0,0,0
6/29/2020,Q2,5,G,Airport,Arrival,554,5,34,593
6/29/2020,Q2,5,G,Airport,Departure,336,4,108,448
6/29/2020,Q2,5,G,Express Rail Link West Kowloon,Arrival,0,0,0,0
6/29/2020,Q2,5,G,Express Rail Link West Kowloon,Departure,0,0,0,0
6/29/2020,Q2,5,G,Hung Hom,Arrival,0,0,0,0
6/29/2020,Q2,5,G,Hung Hom,Departure,0,0,0,0
6/29/2020,Q2,5,G,Lo Wu,Arrival,0,0,0,0
6/29/2020,Q2,5,G,Lo Wu,Departure,0,0,0,0
6/29/2020,Q2,5,G,Lok Ma Chau Spur Line,Arrival,1300,0,0,1300
6/29/2020,Q2,5,G,Lok Ma Chau Spur Line,Departure,1300,0,0,1300
6/29/2020,Q2,5,G,Hong Kong-Zhuhai-Macao Bridge,Arrival,40,3,4,47
6/29/2020,Q2,5,G,Hong Kong-Zhuhai-Macao Bridge,Departure,76,4,3,83
6/29/2020,Q2,5,G,Lok Ma Chau,Arrival,0,0,0,0
6/29/2020,Q2,5,G,Lok Ma Chau,Departure,0,0,0,0
6/29/2020,Q2,5,G,Man Kam To,Arrival,0,0,0,0
6/29/2020,Q2,5,G,Man Kam To,Departure,0,0,0,0
6/29/2020,Q2,5,G,Sha Tau Kok,Arrival,0,0,0,0
6/29/2020,Q2,5,G,Sha Tau Kok,Departure,0,0,0,0
6/29/2020,Q2,5,G,Shenzhen Bay,Arrival,865,80,6,951
6/29/2020,Q2,5,G,Shenzhen Bay,Departure,774,52,20,846
6/29/2020,Q2,5,G,China Ferry Terminal,Arrival,0,0,0,0
6/29/2020,Q2,5,G,China Ferry Terminal,Departure,0,0,0,0
6/29/2020,Q2,5,G,Harbour Control,Arrival,0,0,0,0
6/29/2020,Q2,5,G,Harbour Control,Departure,0,0,0,0
6/29/2020,Q2,5,G,Kai Tak Cruise Terminal,Arrival,0,0,0,0
6/29/2020,Q2,5,G,Kai Tak Cruise Terminal,Departure,0,0,0,0
6/29/2020,Q2,5,G,Macau Ferry Terminal,Arrival,0,0,0,0
6/29/2020,Q2,5,G,Macau Ferry Terminal,Departure,0,0,0,0
6/29/2020,Q2,5,G,Tuen Mun Ferry Terminal,Arrival,0,0,0,0
6/29/2020,Q2,5,G,Tuen Mun Ferry Terminal,Departure,0,0,0,0
6/30/2020,Q2,5,G,Airport,Arrival,1221,7,82,1310
6/30/2020,Q2,5,G,Airport,Departure,730,5,62,797
6/30/2020,Q2,5,G,Express Rail Link West Kowloon,Arrival,0,0,0,0
6/30/2020,Q2,5,G,Express Rail Link West Kowloon,Departure,0,0,0,0
6/30/2020,Q2,5,G,Hung Hom,Arrival,0,0,0,0
6/30/2020,Q2,5,G,Hung Hom,Departure,0,0,0,0
6/30/2020,Q2,5,G,Lo Wu,Arrival,0,0,0,0
6/30/2020,Q2,5,G,Lo Wu,Departure,0,0,0,0
6/30/2020,Q2,5,G,Lok Ma Chau Spur Line,Arrival,1235,0,0,1235
6/30/2020,Q2,5,G,Lok Ma Chau Spur Line,Departure,1235,0,0,1235
6/30/2020,Q2,5,G,Hong Kong-Zhuhai-Macao Bridge,Arrival,42,3,3,48
6/30/2020,Q2,5,G,Hong Kong-Zhuhai-Macao Bridge,Departure,88,4,6,98
6/30/2020,Q2,5,G,Lok Ma Chau,Arrival,0,0,0,0
6/30/2020,Q2,5,G,Lok Ma Chau,Departure,0,0,0,0
6/30/2020,Q2,5,G,Man Kam To,Arrival,0,0,0,0
6/30/2020,Q2,5,G,Man Kam To,Departure,0,0,0,0
6/30/2020,Q2,5,G,Sha Tau Kok,Arrival,0,0,0,0
6/30/2020,Q2,5,G,Sha Tau Kok,Departure,0,0,0,0
6/30/2020,Q2,5,G,Shenzhen Bay,Arrival,928,159,10,1097
6/30/2020,Q2,5,G,Shenzhen Bay,Departure,878,85,3,966
6/30/2020,Q2,5,G,China Ferry Terminal,Arrival,0,0,0,0
6/30/2020,Q2,5,G,China Ferry Terminal,Departure,0,0,0,0
6/30/2020,Q2,5,G,Harbour Control,Arrival,0,0,0,0
6/30/2020,Q2,5,G,Harbour Control,Departure,0,0,0,0
6/30/2020,Q2,5,G,Kai Tak Cruise Terminal,Arrival,0,0,0,0
6/30/2020,Q2,5,G,Kai Tak Cruise Terminal,Departure,0,0,0,0
6/30/2020,Q2,5,G,Macau Ferry Terminal,Arrival,0,0,0,0
6/30/2020,Q2,5,G,Macau Ferry Terminal,Departure,0,0,0,0
6/30/2020,Q2,5,G,Tuen Mun Ferry Terminal,Arrival,0,0,0,0
6/30/2020,Q2,5,G,Tuen Mun Ferry Terminal,Departure,0,0,0,0
7/1/2020,Q3,5,H,Airport,Arrival,682,3,58,743
7/1/2020,Q3,5,H,Airport,Departure,1022,20,82,1124
7/1/2020,Q3,5,H,Express Rail Link West Kowloon,Arrival,0,0,0,0
7/1/2020,Q3,5,H,Express Rail Link West Kowloon,Departure,0,0,0,0
7/1/2020,Q3,5,H,Hung Hom,Arrival,0,0,0,0
7/1/2020,Q3,5,H,Hung Hom,Departure,0,0,0,0
7/1/2020,Q3,5,H,Lo Wu,Arrival,0,0,0,0
7/1/2020,Q3,5,H,Lo Wu,Departure,0,0,0,0
7/1/2020,Q3,5,H,Lok Ma Chau Spur Line,Arrival,0,0,0,0
7/1/2020,Q3,5,H,Lok Ma Chau Spur Line,Departure,0,0,0,0
7/1/2020,Q3,5,H,Hong Kong-Zhuhai-Macao Bridge,Arrival,41,7,4,52
7/1/2020,Q3,5,H,Hong Kong-Zhuhai-Macao Bridge,Departure,75,9,5,89
7/1/2020,Q3,5,H,Lok Ma Chau,Arrival,0,0,0,0
7/1/2020,Q3,5,H,Lok Ma Chau,Departure,0,0,0,0
7/1/2020,Q3,5,H,Man Kam To,Arrival,0,0,0,0
7/1/2020,Q3,5,H,Man Kam To,Departure,0,0,0,0
7/1/2020,Q3,5,H,Sha Tau Kok,Arrival,0,0,0,0
7/1/2020,Q3,5,H,Sha Tau Kok,Departure,0,0,0,0
7/1/2020,Q3,5,H,Shenzhen Bay,Arrival,566,104,8,678
7/1/2020,Q3,5,H,Shenzhen Bay,Departure,496,86,3,585
7/1/2020,Q3,5,H,China Ferry Terminal,Arrival,0,0,0,0
7/1/2020,Q3,5,H,China Ferry Terminal,Departure,0,0,0,0
7/1/2020,Q3,5,H,Harbour Control,Arrival,0,0,0,0
7/1/2020,Q3,5,H,Harbour Control,Departure,0,0,0,0
7/1/2020,Q3,5,H,Kai Tak Cruise Terminal,Arrival,0,0,0,0
7/1/2020,Q3,5,H,Kai Tak Cruise Terminal,Departure,0,0,0,0
7/1/2020,Q3,5,H,Macau Ferry Terminal,Arrival,0,0,0,0
7/1/2020,Q3,5,H,Macau Ferry Terminal,Departure,0,0,0,0
7/1/2020,Q3,5,H,Tuen Mun Ferry Terminal,Arrival,0,0,0,0
7/1/2020,Q3,5,H,Tuen Mun Ferry Terminal,Departure,0,0,0,0
7/2/2020,Q3,5,H,Airport,Arrival,1017,5,75,1097
7/2/2020,Q3,5,H,Airport,Departure,880,23,60,963
7/2/2020,Q3,5,H,Express Rail Link West Kowloon,Arrival,0,0,0,0
7/2/2020,Q3,5,H,Express Rail Link West Kowloon,Departure,0,0,0,0
7/2/2020,Q3,5,H,Hung Hom,Arrival,0,0,0,0
7/2/2020,Q3,5,H,Hung Hom,Departure,0,0,0,0
7/2/2020,Q3,5,H,Lo Wu,Arrival,0,0,0,0
7/2/2020,Q3,5,H,Lo Wu,Departure,0,0,0,0
7/2/2020,Q3,5,H,Lok Ma Chau Spur Line,Arrival,1291,0,0,1291
7/2/2020,Q3,5,H,Lok Ma Chau Spur Line,Departure,1291,0,0,1291
7/2/2020,Q3,5,H,Hong Kong-Zhuhai-Macao Bridge,Arrival,73,1,3,77
7/2/2020,Q3,5,H,Hong Kong-Zhuhai-Macao Bridge,Departure,86,9,3,98
7/2/2020,Q3,5,H,Lok Ma Chau,Arrival,0,0,0,0
7/2/2020,Q3,5,H,Lok Ma Chau,Departure,0,0,0,0
7/2/2020,Q3,5,H,Man Kam To,Arrival,0,0,0,0
7/2/2020,Q3,5,H,Man Kam To,Departure,0,0,0,0
7/2/2020,Q3,5,H,Sha Tau Kok,Arrival,0,0,0,0
7/2/2020,Q3,5,H,Sha Tau Kok,Departure,0,0,0,0
7/2/2020,Q3,5,H,Shenzhen Bay,Arrival,981,86,11,1078
7/2/2020,Q3,5,H,Shenzhen Bay,Departure,918,88,8,1014
7/2/2020,Q3,5,H,China Ferry Terminal,Arrival,0,0,0,0
7/2/2020,Q3,5,H,China Ferry Terminal,Departure,0,0,0,0
7/2/2020,Q3,5,H,Harbour Control,Arrival,0,0,0,0
7/2/2020,Q3,5,H,Harbour Control,Departure,0,0,0,0
7/2/2020,Q3,5,H,Kai Tak Cruise Terminal,Arrival,0,0,0,0
7/2/2020,Q3,5,H,Kai Tak Cruise Terminal,Departure,0,0,0,0
7/2/2020,Q3,5,H,Macau Ferry Terminal,Arrival,0,0,0,0
7/2/2020,Q3,5,H,Macau Ferry Terminal,Departure,0,0,0,0
7/2/2020,Q3,5,H,Tuen Mun Ferry Terminal,Arrival,0,0,0,0
7/2/2020,Q3,5,H,Tuen Mun Ferry Terminal,Departure,0,0,0,0
7/3/2020,Q3,5,H,Airport,Arrival,1145,7,71,1223
7/3/2020,Q3,5,H,Airport,Departure,1054,17,87,1158
7/3/2020,Q3,5,H,Express Rail Link West Kowloon,Arrival,0,0,0,0
7/3/2020,Q3,5,H,Express Rail Link West Kowloon,Departure,0,0,0,0
7/3/2020,Q3,5,H,Hung Hom,Arrival,0,0,0,0
7/3/2020,Q3,5,H,Hung Hom,Departure,0,0,0,0
7/3/2020,Q3,5,H,Lo Wu,Arrival,0,0,0,0
7/3/2020,Q3,5,H,Lo Wu,Departure,0,0,0,0
7/3/2020,Q3,5,H,Lok Ma Chau Spur Line,Arrival,1219,0,0,1219
7/3/2020,Q3,5,H,Lok Ma Chau Spur Line,Departure,1219,0,0,1219
7/3/2020,Q3,5,H,Hong Kong-Zhuhai-Macao Bridge,Arrival,57,7,3,67
7/3/2020,Q3,5,H,Hong Kong-Zhuhai-Macao Bridge,Departure,84,6,7,97
7/3/2020,Q3,5,H,Lok Ma Chau,Arrival,0,0,0,0
7/3/2020,Q3,5,H,Lok Ma Chau,Departure,0,0,0,0
7/3/2020,Q3,5,H,Man Kam To,Arrival,0,0,0,0
7/3/2020,Q3,5,H,Man Kam To,Departure,0,0,0,0
7/3/2020,Q3,5,H,Sha Tau Kok,Arrival,0,0,0,0
7/3/2020,Q3,5,H,Sha Tau Kok,Departure,0,0,0,0
7/3/2020,Q3,5,H,Shenzhen Bay,Arrival,1063,134,5,1202
7/3/2020,Q3,5,H,Shenzhen Bay,Departure,868,107,14,989
7/3/2020,Q3,5,H,China Ferry Terminal,Arrival,0,0,0,0
7/3/2020,Q3,5,H,China Ferry Terminal,Departure,0,0,0,0
7/3/2020,Q3,5,H,Harbour Control,Arrival,0,0,0,0
7/3/2020,Q3,5,H,Harbour Control,Departure,0,0,0,0
7/3/2020,Q3,5,H,Kai Tak Cruise Terminal,Arrival,0,0,0,0
7/3/2020,Q3,5,H,Kai Tak Cruise Terminal,Departure,0,0,0,0
7/3/2020,Q3,5,H,Macau Ferry Terminal,Arrival,0,0,0,0
7/3/2020,Q3,5,H,Macau Ferry Terminal,Departure,0,0,0,0
7/3/2020,Q3,5,H,Tuen Mun Ferry Terminal,Arrival,0,0,0,0
7/3/2020,Q3,5,H,Tuen Mun Ferry Terminal,Departure,0,0,0,0
7/4/2020,Q3,5,H,Airport,Arrival,1068,13,57,1138
7/4/2020,Q3,5,H,Airport,Departure,809,9,133,951
7/4/2020,Q3,5,H,Express Rail Link West Kowloon,Arrival,0,0,0,0
7/4/2020,Q3,5,H,Express Rail Link West Kowloon,Departure,0,0,0,0
7/4/2020,Q3,5,H,Hung Hom,Arrival,0,0,0,0
7/4/2020,Q3,5,H,Hung Hom,Departure,0,0,0,0
7/4/2020,Q3,5,H,Lo Wu,Arrival,0,0,0,0
7/4/2020,Q3,5,H,Lo Wu,Departure,0,0,0,0
7/4/2020,Q3,5,H,Lok Ma Chau Spur Line,Arrival,0,0,0,0
7/4/2020,Q3,5,H,Lok Ma Chau Spur Line,Departure,0,0,0,0
7/4/2020,Q3,5,H,Hong Kong-Zhuhai-Macao Bridge,Arrival,66,8,3,77
7/4/2020,Q3,5,H,Hong Kong-Zhuhai-Macao Bridge,Departure,79,3,5,87
7/4/2020,Q3,5,H,Lok Ma Chau,Arrival,0,0,0,0
7/4/2020,Q3,5,H,Lok Ma Chau,Departure,0,0,0,0
7/4/2020,Q3,5,H,Man Kam To,Arrival,0,0,0,0
7/4/2020,Q3,5,H,Man Kam To,Departure,0,0,0,0
7/4/2020,Q3,5,H,Sha Tau Kok,Arrival,0,0,0,0
7/4/2020,Q3,5,H,Sha Tau Kok,Departure,0,0,0,0
7/4/2020,Q3,5,H,Shenzhen Bay,Arrival,746,145,11,902
7/4/2020,Q3,5,H,Shenzhen Bay,Departure,707,109,14,830
7/4/2020,Q3,5,H,China Ferry Terminal,Arrival,0,0,0,0
7/4/2020,Q3,5,H,China Ferry Terminal,Departure,0,0,0,0
7/4/2020,Q3,5,H,Harbour Control,Arrival,0,0,0,0
7/4/2020,Q3,5,H,Harbour Control,Departure,0,0,0,0
7/4/2020,Q3,5,H,Kai Tak Cruise Terminal,Arrival,0,0,0,0
7/4/2020,Q3,5,H,Kai Tak Cruise Terminal,Departure,0,0,0,0
7/4/2020,Q3,5,H,Macau Ferry Terminal,Arrival,0,0,0,0
7/4/2020,Q3,5,H,Macau Ferry Terminal,Departure,0,0,0,0
7/4/2020,Q3,5,H,Tuen Mun Ferry Terminal,Arrival,0,0,0,0
7/4/2020,Q3,5,H,Tuen Mun Ferry Terminal,Departure,0,0,0,0
7/5/2020,Q3,5,H,Airport,Arrival,1276,6,48,1330
7/5/2020,Q3,5,H,Airport,Departure,994,14,151,1159
7/5/2020,Q3,5,H,Express Rail Link West Kowloon,Arrival,0,0,0,0
7/5/2020,Q3,5,H,Express Rail Link West Kowloon,Departure,0,0,0,0
7/5/2020,Q3,5,H,Hung Hom,Arrival,0,0,0,0
7/5/2020,Q3,5,H,Hung Hom,Departure,0,0,0,0
7/5/2020,Q3,5,H,Lo Wu,Arrival,0,0,0,0
7/5/2020,Q3,5,H,Lo Wu,Departure,0,0,0,0
7/5/2020,Q3,5,H,Lok Ma Chau Spur Line,Arrival,0,0,0,0
7/5/2020,Q3,5,H,Lok Ma Chau Spur Line,Departure,0,0,0,0
7/5/2020,Q3,5,H,Hong Kong-Zhuhai-Macao Bridge,Arrival,70,6,4,80
7/5/2020,Q3,5,H,Hong Kong-Zhuhai-Macao Bridge,Departure,89,12,2,103
7/5/2020,Q3,5,H,Lok Ma Chau,Arrival,0,0,0,0
7/5/2020,Q3,5,H,Lok Ma Chau,Departure,0,0,0,0
7/5/2020,Q3,5,H,Man Kam To,Arrival,0,0,0,0
7/5/2020,Q3,5,H,Man Kam To,Departure,0,0,0,0
7/5/2020,Q3,5,H,Sha Tau Kok,Arrival,0,0,0,0
7/5/2020,Q3,5,H,Sha Tau Kok,Departure,0,0,0,0
7/5/2020,Q3,5,H,Shenzhen Bay,Arrival,942,197,13,1152
7/5/2020,Q3,5,H,Shenzhen Bay,Departure,664,131,4,799
7/5/2020,Q3,5,H,China Ferry Terminal,Arrival,0,0,0,0
7/5/2020,Q3,5,H,China Ferry Terminal,Departure,0,0,0,0
7/5/2020,Q3,5,H,Harbour Control,Arrival,0,0,0,0
7/5/2020,Q3,5,H,Harbour Control,Departure,0,0,0,0
7/5/2020,Q3,5,H,Kai Tak Cruise Terminal,Arrival,0,0,0,0
7/5/2020,Q3,5,H,Kai Tak Cruise Terminal,Departure,0,0,0,0
7/5/2020,Q3,5,H,Macau Ferry Terminal,Arrival,0,0,0,0
7/5/2020,Q3,5,H,Macau Ferry Terminal,Departure,0,0,0,0
7/5/2020,Q3,5,H,Tuen Mun Ferry Terminal,Arrival,0,0,0,0
7/5/2020,Q3,5,H,Tuen Mun Ferry Terminal,Departure,0,0,0,0
7/6/2020,Q3,5,H,Airport,Arrival,843,4,46,893
7/6/2020,Q3,5,H,Airport,Departure,312,2,110,424
7/6/2020,Q3,5,H,Express Rail Link West Kowloon,Arrival,0,0,0,0
7/6/2020,Q3,5,H,Express Rail Link West Kowloon,Departure,0,0,0,0
7/6/2020,Q3,5,H,Hung Hom,Arrival,0,0,0,0
7/6/2020,Q3,5,H,Hung Hom,Departure,0,0,0,0
7/6/2020,Q3,5,H,Lo Wu,Arrival,0,0,0,0
7/6/2020,Q3,5,H,Lo Wu,Departure,0,0,0,0
7/6/2020,Q3,5,H,Lok Ma Chau Spur Line,Arrival,1133,0,0,1133
7/6/2020,Q3,5,H,Lok Ma Chau Spur Line,Departure,1133,0,0,1133
7/6/2020,Q3,5,H,Hong Kong-Zhuhai-Macao Bridge,Arrival,106,2,3,111
7/6/2020,Q3,5,H,Hong Kong-Zhuhai-Macao Bridge,Departure,113,6,4,123
7/6/2020,Q3,5,H,Lok Ma Chau,Arrival,0,0,0,0
7/6/2020,Q3,5,H,Lok Ma Chau,Departure,0,0,0,0
7/6/2020,Q3,5,H,Man Kam To,Arrival,0,0,0,0
7/6/2020,Q3,5,H,Man Kam To,Departure,0,0,0,0
7/6/2020,Q3,5,H,Sha Tau Kok,Arrival,0,0,0,0
7/6/2020,Q3,5,H,Sha Tau Kok,Departure,0,0,0,0
7/6/2020,Q3,5,H,Shenzhen Bay,Arrival,1318,137,16,1471
7/6/2020,Q3,5,H,Shenzhen Bay,Departure,1040,117,16,1173
7/6/2020,Q3,5,H,China Ferry Terminal,Arrival,0,0,0,0
7/6/2020,Q3,5,H,China Ferry Terminal,Departure,0,0,0,0
7/6/2020,Q3,5,H,Harbour Control,Arrival,0,0,0,0
7/6/2020,Q3,5,H,Harbour Control,Departure,0,0,0,0
7/6/2020,Q3,5,H,Kai Tak Cruise Terminal,Arrival,0,0,0,0
7/6/2020,Q3,5,H,Kai Tak Cruise Terminal,Departure,0,0,0,0
7/6/2020,Q3,5,H,Macau Ferry Terminal,Arrival,0,0,0,0
7/6/2020,Q3,5,H,Macau Ferry Terminal,Departure,0,0,0,0
7/6/2020,Q3,5,H,Tuen Mun Ferry Terminal,Arrival,0,0,0,0
7/6/2020,Q3,5,H,Tuen Mun Ferry Terminal,Departure,0,0,0,0
7/7/2020,Q3,5,H,Airport,Arrival,1044,8,36,1088
7/7/2020,Q3,5,H,Airport,Departure,819,18,81,918
7/7/2020,Q3,5,H,Express Rail Link West Kowloon,Arrival,0,0,0,0
7/7/2020,Q3,5,H,Express Rail Link West Kowloon,Departure,0,0,0,0
7/7/2020,Q3,5,H,Hung Hom,Arrival,0,0,0,0
7/7/2020,Q3,5,H,Hung Hom,Departure,0,0,0,0
7/7/2020,Q3,5,H,Lo Wu,Arrival,0,0,0,0
7/7/2020,Q3,5,H,Lo Wu,Departure,0,0,0,0
7/7/2020,Q3,5,H,Lok Ma Chau Spur Line,Arrival,1186,0,0,1186
7/7/2020,Q3,5,H,Lok Ma Chau Spur Line,Departure,1186,0,0,1186
7/7/2020,Q3,5,H,Hong Kong-Zhuhai-Macao Bridge,Arrival,104,4,9,117
7/7/2020,Q3,5,H,Hong Kong-Zhuhai-Macao Bridge,Departure,138,5,8,151
7/7/2020,Q3,5,H,Lok Ma Chau,Arrival,0,0,0,0
7/7/2020,Q3,5,H,Lok Ma Chau,Departure,0,0,0,0
7/7/2020,Q3,5,H,Man Kam To,Arrival,0,0,0,0
7/7/2020,Q3,5,H,Man Kam To,Departure,0,0,0,0
7/7/2020,Q3,5,H,Sha Tau Kok,Arrival,0,0,0,0
7/7/2020,Q3,5,H,Sha Tau Kok,Departure,0,0,0,0
7/7/2020,Q3,5,H,Shenzhen Bay,Arrival,1279,155,14,1448
7/7/2020,Q3,5,H,Shenzhen Bay,Departure,1106,130,6,1242
7/7/2020,Q3,5,H,China Ferry Terminal,Arrival,0,0,0,0
7/7/2020,Q3,5,H,China Ferry Terminal,Departure,0,0,0,0
7/7/2020,Q3,5,H,Harbour Control,Arrival,0,0,0,0
7/7/2020,Q3,5,H,Harbour Control,Departure,0,0,0,0
7/7/2020,Q3,5,H,Kai Tak Cruise Terminal,Arrival,0,0,0,0
7/7/2020,Q3,5,H,Kai Tak Cruise Terminal,Departure,0,0,0,0
7/7/2020,Q3,5,H,Macau Ferry Terminal,Arrival,0,0,0,0
7/7/2020,Q3,5,H,Macau Ferry Terminal,Departure,0,0,0,0
7/7/2020,Q3,5,H,Tuen Mun Ferry Terminal,Arrival,0,0,0,0
7/7/2020,Q3,5,H,Tuen Mun Ferry Terminal,Departure,0,0,0,0
7/8/2020,Q3,5,H,Airport,Arrival,1091,11,76,1178
7/8/2020,Q3,5,H,Airport,Departure,774,5,197,976
7/8/2020,Q3,5,H,Express Rail Link West Kowloon,Arrival,0,0,0,0
7/8/2020,Q3,5,H,Express Rail Link West Kowloon,Departure,0,0,0,0
7/8/2020,Q3,5,H,Hung Hom,Arrival,0,0,0,0
7/8/2020,Q3,5,H,Hung Hom,Departure,0,0,0,0
7/8/2020,Q3,5,H,Lo Wu,Arrival,0,0,0,0
7/8/2020,Q3,5,H,Lo Wu,Departure,0,0,0,0
7/8/2020,Q3,5,H,Lok Ma Chau Spur Line,Arrival,1030,0,0,1030
7/8/2020,Q3,5,H,Lok Ma Chau Spur Line,Departure,1030,0,0,1030
7/8/2020,Q3,5,H,Hong Kong-Zhuhai-Macao Bridge,Arrival,122,6,6,134
7/8/2020,Q3,5,H,Hong Kong-Zhuhai-Macao Bridge,Departure,172,7,8,187
7/8/2020,Q3,5,H,Lok Ma Chau,Arrival,0,0,0,0
7/8/2020,Q3,5,H,Lok Ma Chau,Departure,0,0,0,0
7/8/2020,Q3,5,H,Man Kam To,Arrival,0,0,0,0
7/8/2020,Q3,5,H,Man Kam To,Departure,0,0,0,0
7/8/2020,Q3,5,H,Sha Tau Kok,Arrival,0,0,0,0
7/8/2020,Q3,5,H,Sha Tau Kok,Departure,0,0,0,0
7/8/2020,Q3,5,H,Shenzhen Bay,Arrival,1428,184,20,1632
7/8/2020,Q3,5,H,Shenzhen Bay,Departure,1341,175,5,1521
7/8/2020,Q3,5,H,China Ferry Terminal,Arrival,0,0,0,0
7/8/2020,Q3,5,H,China Ferry Terminal,Departure,0,0,0,0
7/8/2020,Q3,5,H,Harbour Control,Arrival,0,0,0,0
7/8/2020,Q3,5,H,Harbour Control,Departure,0,0,0,0
7/8/2020,Q3,5,H,Kai Tak Cruise Terminal,Arrival,0,0,0,0
7/8/2020,Q3,5,H,Kai Tak Cruise Terminal,Departure,0,0,0,0
7/8/2020,Q3,5,H,Macau Ferry Terminal,Arrival,0,0,0,0
7/8/2020,Q3,5,H,Macau Ferry Terminal,Departure,0,0,0,0
7/8/2020,Q3,5,H,Tuen Mun Ferry Terminal,Arrival,0,0,0,0
7/8/2020,Q3,5,H,Tuen Mun Ferry Terminal,Departure,0,0,0,0
7/9/2020,Q3,5,H,Airport,Arrival,661,9,44,714
7/9/2020,Q3,5,H,Airport,Departure,727,21,84,832
7/9/2020,Q3,5,H,Express Rail Link West Kowloon,Arrival,0,0,0,0
7/9/2020,Q3,5,H,Express Rail Link West Kowloon,Departure,0,0,0,0
7/9/2020,Q3,5,H,Hung Hom,Arrival,0,0,0,0
7/9/2020,Q3,5,H,Hung Hom,Departure,0,0,0,0
7/9/2020,Q3,5,H,Lo Wu,Arrival,0,0,0,0
7/9/2020,Q3,5,H,Lo Wu,Departure,0,0,0,0
7/9/2020,Q3,5,H,Lok Ma Chau Spur Line,Arrival,721,0,0,721
7/9/2020,Q3,5,H,Lok Ma Chau Spur Line,Departure,721,0,0,721
7/9/2020,Q3,5,H,Hong Kong-Zhuhai-Macao Bridge,Arrival,98,5,3,106
7/9/2020,Q3,5,H,Hong Kong-Zhuhai-Macao Bridge,Departure,212,10,8,230
7/9/2020,Q3,5,H,Lok Ma Chau,Arrival,0,0,0,0
7/9/2020,Q3,5,H,Lok Ma Chau,Departure,0,0,0,0
7/9/2020,Q3,5,H,Man Kam To,Arrival,0,0,0,0
7/9/2020,Q3,5,H,Man Kam To,Departure,0,0,0,0
7/9/2020,Q3,5,H,Sha Tau Kok,Arrival,0,0,0,0
7/9/2020,Q3,5,H,Sha Tau Kok,Departure,0,0,0,0
7/9/2020,Q3,5,H,Shenzhen Bay,Arrival,1336,161,7,1504
7/9/2020,Q3,5,H,Shenzhen Bay,Departure,1178,195,9,1382
7/9/2020,Q3,5,H,China Ferry Terminal,Arrival,0,0,0,0
7/9/2020,Q3,5,H,China Ferry Terminal,Departure,0,0,0,0
7/9/2020,Q3,5,H,Harbour Control,Arrival,0,0,0,0
7/9/2020,Q3,5,H,Harbour Control,Departure,0,0,0,0
7/9/2020,Q3,5,H,Kai Tak Cruise Terminal,Arrival,0,0,0,0
7/9/2020,Q3,5,H,Kai Tak Cruise Terminal,Departure,0,0,0,0
7/9/2020,Q3,5,H,Macau Ferry Terminal,Arrival,0,0,0,0
7/9/2020,Q3,5,H,Macau Ferry Terminal,Departure,0,0,0,0
7/9/2020,Q3,5,H,Tuen Mun Ferry Terminal,Arrival,0,0,0,0
7/9/2020,Q3,5,H,Tuen Mun Ferry Terminal,Departure,0,0,0,0
7/10/2020,Q3,5,H,Airport,Arrival,1298,2,105,1405
7/10/2020,Q3,5,H,Airport,Departure,852,29,96,977
7/10/2020,Q3,5,H,Express Rail Link West Kowloon,Arrival,0,0,0,0
7/10/2020,Q3,5,H,Express Rail Link West Kowloon,Departure,0,0,0,0
7/10/2020,Q3,5,H,Hung Hom,Arrival,0,0,0,0
7/10/2020,Q3,5,H,Hung Hom,Departure,0,0,0,0
7/10/2020,Q3,5,H,Lo Wu,Arrival,0,0,0,0
7/10/2020,Q3,5,H,Lo Wu,Departure,0,0,0,0
7/10/2020,Q3,5,H,Lok Ma Chau Spur Line,Arrival,827,0,0,827
7/10/2020,Q3,5,H,Lok Ma Chau Spur Line,Departure,827,0,0,827
7/10/2020,Q3,5,H,Hong Kong-Zhuhai-Macao Bridge,Arrival,102,11,5,118
7/10/2020,Q3,5,H,Hong Kong-Zhuhai-Macao Bridge,Departure,239,23,16,278
7/10/2020,Q3,5,H,Lok Ma Chau,Arrival,0,0,0,0
7/10/2020,Q3,5,H,Lok Ma Chau,Departure,0,0,0,0
7/10/2020,Q3,5,H,Man Kam To,Arrival,0,0,0,0
7/10/2020,Q3,5,H,Man Kam To,Departure,0,0,0,0
7/10/2020,Q3,5,H,Sha Tau Kok,Arrival,0,0,0,0
7/10/2020,Q3,5,H,Sha Tau Kok,Departure,0,0,0,0
7/10/2020,Q3,5,H,Shenzhen Bay,Arrival,1102,162,10,1274
7/10/2020,Q3,5,H,Shenzhen Bay,Departure,1567,229,16,1812
7/10/2020,Q3,5,H,China Ferry Terminal,Arrival,0,0,0,0
7/10/2020,Q3,5,H,China Ferry Terminal,Departure,0,0,0,0
7/10/2020,Q3,5,H,Harbour Control,Arrival,0,0,0,0
7/10/2020,Q3,5,H,Harbour Control,Departure,0,0,0,0
7/10/2020,Q3,5,H,Kai Tak Cruise Terminal,Arrival,0,0,0,0
7/10/2020,Q3,5,H,Kai Tak Cruise Terminal,Departure,0,0,0,0
7/10/2020,Q3,5,H,Macau Ferry Terminal,Arrival,0,0,0,0
7/10/2020,Q3,5,H,Macau Ferry Terminal,Departure,0,0,0,0
7/10/2020,Q3,5,H,Tuen Mun Ferry Terminal,Arrival,0,0,0,0
7/10/2020,Q3,5,H,Tuen Mun Ferry Terminal,Departure,0,0,0,0
7/11/2020,Q3,5,H,Airport,Arrival,1248,13,75,1336
7/11/2020,Q3,5,H,Airport,Departure,791,19,92,902
7/11/2020,Q3,5,H,Express Rail Link West Kowloon,Arrival,0,0,0,0
7/11/2020,Q3,5,H,Express Rail Link West Kowloon,Departure,0,0,0,0
7/11/2020,Q3,5,H,Hung Hom,Arrival,0,0,0,0
7/11/2020,Q3,5,H,Hung Hom,Departure,0,0,0,0
7/11/2020,Q3,5,H,Lo Wu,Arrival,0,0,0,0
7/11/2020,Q3,5,H,Lo Wu,Departure,0,0,0,0
7/11/2020,Q3,5,H,Lok Ma Chau Spur Line,Arrival,0,0,0,0
7/11/2020,Q3,5,H,Lok Ma Chau Spur Line,Departure,0,0,0,0
7/11/2020,Q3,5,H,Hong Kong-Zhuhai-Macao Bridge,Arrival,75,2,7,84
7/11/2020,Q3,5,H,Hong Kong-Zhuhai-Macao Bridge,Departure,263,41,9,313
7/11/2020,Q3,5,H,Lok Ma Chau,Arrival,0,0,0,0
7/11/2020,Q3,5,H,Lok Ma Chau,Departure,0,0,0,0
7/11/2020,Q3,5,H,Man Kam To,Arrival,0,0,0,0
7/11/2020,Q3,5,H,Man Kam To,Departure,0,0,0,0
7/11/2020,Q3,5,H,Sha Tau Kok,Arrival,0,0,0,0
7/11/2020,Q3,5,H,Sha Tau Kok,Departure,0,0,0,0
7/11/2020,Q3,5,H,Shenzhen Bay,Arrival,737,159,10,906
7/11/2020,Q3,5,H,Shenzhen Bay,Departure,2017,427,11,2455
7/11/2020,Q3,5,H,China Ferry Terminal,Arrival,0,0,0,0
7/11/2020,Q3,5,H,China Ferry Terminal,Departure,0,0,0,0
7/11/2020,Q3,5,H,Harbour Control,Arrival,0,0,0,0
7/11/2020,Q3,5,H,Harbour Control,Departure,0,0,0,0
7/11/2020,Q3,5,H,Kai Tak Cruise Terminal,Arrival,0,0,0,0
7/11/2020,Q3,5,H,Kai Tak Cruise Terminal,Departure,0,0,0,0
7/11/2020,Q3,5,H,Macau Ferry Terminal,Arrival,0,0,0,0
7/11/2020,Q3,5,H,Macau Ferry Terminal,Departure,0,0,0,0
7/11/2020,Q3,5,H,Tuen Mun Ferry Terminal,Arrival,0,0,0,0
7/11/2020,Q3,5,H,Tuen Mun Ferry Terminal,Departure,0,0,0,0
7/12/2020,Q3,5,H,Airport,Arrival,1105,10,79,1194
7/12/2020,Q3,5,H,Airport,Departure,1114,61,109,1284
7/12/2020,Q3,5,H,Express Rail Link West Kowloon,Arrival,0,0,0,0
7/12/2020,Q3,5,H,Express Rail Link West Kowloon,Departure,0,0,0,0
7/12/2020,Q3,5,H,Hung Hom,Arrival,0,0,0,0
7/12/2020,Q3,5,H,Hung Hom,Departure,0,0,0,0
7/12/2020,Q3,5,H,Lo Wu,Arrival,0,0,0,0
7/12/2020,Q3,5,H,Lo Wu,Departure,0,0,0,0
7/12/2020,Q3,5,H,Lok Ma Chau Spur Line,Arrival,0,0,0,0
7/12/2020,Q3,5,H,Lok Ma Chau Spur Line,Departure,0,0,0,0
7/12/2020,Q3,5,H,Hong Kong-Zhuhai-Macao Bridge,Arrival,71,6,9,86
7/12/2020,Q3,5,H,Hong Kong-Zhuhai-Macao Bridge,Departure,259,34,5,298
7/12/2020,Q3,5,H,Lok Ma Chau,Arrival,0,0,0,0
7/12/2020,Q3,5,H,Lok Ma Chau,Departure,0,0,0,0
7/12/2020,Q3,5,H,Man Kam To,Arrival,0,0,0,0
7/12/2020,Q3,5,H,Man Kam To,Departure,0,0,0,0
7/12/2020,Q3,5,H,Sha Tau Kok,Arrival,0,0,0,0
7/12/2020,Q3,5,H,Sha Tau Kok,Departure,0,0,0,0
7/12/2020,Q3,5,H,Shenzhen Bay,Arrival,826,116,7,949
7/12/2020,Q3,5,H,Shenzhen Bay,Departure,1528,339,17,1884
7/12/2020,Q3,5,H,China Ferry Terminal,Arrival,0,0,0,0
7/12/2020,Q3,5,H,China Ferry Terminal,Departure,0,0,0,0
7/12/2020,Q3,5,H,Harbour Control,Arrival,0,0,0,0
7/12/2020,Q3,5,H,Harbour Control,Departure,0,0,0,0
7/12/2020,Q3,5,H,Kai Tak Cruise Terminal,Arrival,0,0,0,0
7/12/2020,Q3,5,H,Kai Tak Cruise Terminal,Departure,0,0,0,0
7/12/2020,Q3,5,H,Macau Ferry Terminal,Arrival,0,0,0,0
7/12/2020,Q3,5,H,Macau Ferry Terminal,Departure,0,0,0,0
7/12/2020,Q3,5,H,Tuen Mun Ferry Terminal,Arrival,0,0,0,0
7/12/2020,Q3,5,H,Tuen Mun Ferry Terminal,Departure,0,0,0,0
7/13/2020,Q3,5,H,Airport,Arrival,731,9,55,795
7/13/2020,Q3,5,H,Airport,Departure,326,30,62,418
7/13/2020,Q3,5,H,Express Rail Link West Kowloon,Arrival,0,0,0,0
7/13/2020,Q3,5,H,Express Rail Link West Kowloon,Departure,0,0,0,0
7/13/2020,Q3,5,H,Hung Hom,Arrival,0,0,0,0
7/13/2020,Q3,5,H,Hung Hom,Departure,0,0,0,0
7/13/2020,Q3,5,H,Lo Wu,Arrival,0,0,0,0
7/13/2020,Q3,5,H,Lo Wu,Departure,0,0,0,0
7/13/2020,Q3,5,H,Lok Ma Chau Spur Line,Arrival,151,0,0,151
7/13/2020,Q3,5,H,Lok Ma Chau Spur Line,Departure,151,0,0,151
7/13/2020,Q3,5,H,Hong Kong-Zhuhai-Macao Bridge,Arrival,99,2,3,104
7/13/2020,Q3,5,H,Hong Kong-Zhuhai-Macao Bridge,Departure,393,43,4,440
7/13/2020,Q3,5,H,Lok Ma Chau,Arrival,0,0,0,0
7/13/2020,Q3,5,H,Lok Ma Chau,Departure,0,0,0,0
7/13/2020,Q3,5,H,Man Kam To,Arrival,0,0,0,0
7/13/2020,Q3,5,H,Man Kam To,Departure,0,0,0,0
7/13/2020,Q3,5,H,Sha Tau Kok,Arrival,0,0,0,0
7/13/2020,Q3,5,H,Sha Tau Kok,Departure,0,0,0,0
7/13/2020,Q3,5,H,Shenzhen Bay,Arrival,935,109,11,1055
7/13/2020,Q3,5,H,Shenzhen Bay,Departure,2326,355,21,2702
7/13/2020,Q3,5,H,China Ferry Terminal,Arrival,0,0,0,0
7/13/2020,Q3,5,H,China Ferry Terminal,Departure,0,0,0,0
7/13/2020,Q3,5,H,Harbour Control,Arrival,0,0,0,0
7/13/2020,Q3,5,H,Harbour Control,Departure,0,0,0,0
7/13/2020,Q3,5,H,Kai Tak Cruise Terminal,Arrival,0,0,0,0
7/13/2020,Q3,5,H,Kai Tak Cruise Terminal,Departure,0,0,0,0
7/13/2020,Q3,5,H,Macau Ferry Terminal,Arrival,0,0,0,0
7/13/2020,Q3,5,H,Macau Ferry Terminal,Departure,0,0,0,0
7/13/2020,Q3,5,H,Tuen Mun Ferry Terminal,Arrival,0,0,0,0
7/13/2020,Q3,5,H,Tuen Mun Ferry Terminal,Departure,0,0,0,0
7/14/2020,Q3,5,H,Airport,Arrival,768,8,55,831
7/14/2020,Q3,5,H,Airport,Departure,1082,66,84,1232
7/14/2020,Q3,5,H,Express Rail Link West Kowloon,Arrival,0,0,0,0
7/14/2020,Q3,5,H,Express Rail Link West Kowloon,Departure,0,0,0,0
7/14/2020,Q3,5,H,Hung Hom,Arrival,0,0,0,0
7/14/2020,Q3,5,H,Hung Hom,Departure,0,0,0,0
7/14/2020,Q3,5,H,Lo Wu,Arrival,0,0,0,0
7/14/2020,Q3,5,H,Lo Wu,Departure,0,0,0,0
7/14/2020,Q3,5,H,Lok Ma Chau Spur Line,Arrival,57,0,0,57
7/14/2020,Q3,5,H,Lok Ma Chau Spur Line,Departure,57,0,0,57
7/14/2020,Q3,5,H,Hong Kong-Zhuhai-Macao Bridge,Arrival,47,2,1,50
7/14/2020,Q3,5,H,Hong Kong-Zhuhai-Macao Bridge,Departure,516,65,5,586
7/14/2020,Q3,5,H,Lok Ma Chau,Arrival,0,0,0,0
7/14/2020,Q3,5,H,Lok Ma Chau,Departure,0,0,0,0
7/14/2020,Q3,5,H,Man Kam To,Arrival,0,0,0,0
7/14/2020,Q3,5,H,Man Kam To,Departure,0,0,0,0
7/14/2020,Q3,5,H,Sha Tau Kok,Arrival,0,0,0,0
7/14/2020,Q3,5,H,Sha Tau Kok,Departure,0,0,0,0
7/14/2020,Q3,5,H,Shenzhen Bay,Arrival,715,88,7,810
7/14/2020,Q3,5,H,Shenzhen Bay,Departure,2694,469,19,3182
7/14/2020,Q3,5,H,China Ferry Terminal,Arrival,0,0,0,0
7/14/2020,Q3,5,H,China Ferry Terminal,Departure,0,0,0,0
7/14/2020,Q3,5,H,Harbour Control,Arrival,0,0,0,0
7/14/2020,Q3,5,H,Harbour Control,Departure,0,0,0,0
7/14/2020,Q3,5,H,Kai Tak Cruise Terminal,Arrival,0,0,0,0
7/14/2020,Q3,5,H,Kai Tak Cruise Terminal,Departure,0,0,0,0
7/14/2020,Q3,5,H,Macau Ferry Terminal,Arrival,0,0,0,0
7/14/2020,Q3,5,H,Macau Ferry Terminal,Departure,0,0,0,0
7/14/2020,Q3,5,H,Tuen Mun Ferry Terminal,Arrival,0,0,0,0
7/14/2020,Q3,5,H,Tuen Mun Ferry Terminal,Departure,0,0,0,0
7/15/2020,Q3,5,H,Airport,Arrival,1035,3,58,1096
7/15/2020,Q3,5,H,Airport,Departure,880,20,74,974
7/15/2020,Q3,5,H,Express Rail Link West Kowloon,Arrival,0,0,0,0
7/15/2020,Q3,5,H,Express Rail Link West Kowloon,Departure,0,0,0,0
7/15/2020,Q3,5,H,Hung Hom,Arrival,0,0,0,0
7/15/2020,Q3,5,H,Hung Hom,Departure,0,0,0,0
7/15/2020,Q3,5,H,Lo Wu,Arrival,0,0,0,0
7/15/2020,Q3,5,H,Lo Wu,Departure,0,0,0,0
7/15/2020,Q3,5,H,Lok Ma Chau Spur Line,Arrival,65,0,0,65
7/15/2020,Q3,5,H,Lok Ma Chau Spur Line,Departure,65,0,0,65
7/15/2020,Q3,5,H,Hong Kong-Zhuhai-Macao Bridge,Arrival,98,3,3,104
7/15/2020,Q3,5,H,Hong Kong-Zhuhai-Macao Bridge,Departure,637,87,8,732
7/15/2020,Q3,5,H,Lok Ma Chau,Arrival,0,0,0,0
7/15/2020,Q3,5,H,Lok Ma Chau,Departure,0,0,0,0
7/15/2020,Q3,5,H,Man Kam To,Arrival,0,0,0,0
7/15/2020,Q3,5,H,Man Kam To,Departure,0,0,0,0
7/15/2020,Q3,5,H,Sha Tau Kok,Arrival,0,0,0,0
7/15/2020,Q3,5,H,Sha Tau Kok,Departure,0,0,0,0
7/15/2020,Q3,5,H,Shenzhen Bay,Arrival,752,83,7,842
7/15/2020,Q3,5,H,Shenzhen Bay,Departure,2660,470,16,3146
7/15/2020,Q3,5,H,China Ferry Terminal,Arrival,0,0,0,0
7/15/2020,Q3,5,H,China Ferry Terminal,Departure,0,0,0,0
7/15/2020,Q3,5,H,Harbour Control,Arrival,0,0,0,0
7/15/2020,Q3,5,H,Harbour Control,Departure,0,0,0,0
7/15/2020,Q3,5,H,Kai Tak Cruise Terminal,Arrival,0,0,0,0
7/15/2020,Q3,5,H,Kai Tak Cruise Terminal,Departure,0,0,0,0
7/15/2020,Q3,5,H,Macau Ferry Terminal,Arrival,0,0,0,0
7/15/2020,Q3,5,H,Macau Ferry Terminal,Departure,0,0,0,0
7/15/2020,Q3,5,H,Tuen Mun Ferry Terminal,Arrival,0,0,0,0
7/15/2020,Q3,5,H,Tuen Mun Ferry Terminal,Departure,0,0,0,0
7/16/2020,Q3,5,H,Airport,Arrival,516,3,28,547
7/16/2020,Q3,5,H,Airport,Departure,706,24,36,766
7/16/2020,Q3,5,H,Express Rail Link West Kowloon,Arrival,0,0,0,0
7/16/2020,Q3,5,H,Express Rail Link West Kowloon,Departure,0,0,0,0
7/16/2020,Q3,5,H,Hung Hom,Arrival,0,0,0,0
7/16/2020,Q3,5,H,Hung Hom,Departure,0,0,0,0
7/16/2020,Q3,5,H,Lo Wu,Arrival,0,0,0,0
7/16/2020,Q3,5,H,Lo Wu,Departure,0,0,0,0
7/16/2020,Q3,5,H,Lok Ma Chau Spur Line,Arrival,58,0,0,58
7/16/2020,Q3,5,H,Lok Ma Chau Spur Line,Departure,58,0,0,58
7/16/2020,Q3,5,H,Hong Kong-Zhuhai-Macao Bridge,Arrival,91,5,8,104
7/16/2020,Q3,5,H,Hong Kong-Zhuhai-Macao Bridge,Departure,538,66,8,612
7/16/2020,Q3,5,H,Lok Ma Chau,Arrival,0,0,0,0
7/16/2020,Q3,5,H,Lok Ma Chau,Departure,0,0,0,0
7/16/2020,Q3,5,H,Man Kam To,Arrival,0,0,0,0
7/16/2020,Q3,5,H,Man Kam To,Departure,0,0,0,0
7/16/2020,Q3,5,H,Sha Tau Kok,Arrival,0,0,0,0
7/16/2020,Q3,5,H,Sha Tau Kok,Departure,0,0,0,0
7/16/2020,Q3,5,H,Shenzhen Bay,Arrival,651,85,8,744
7/16/2020,Q3,5,H,Shenzhen Bay,Departure,2576,346,16,2938
7/16/2020,Q3,5,H,China Ferry Terminal,Arrival,0,0,0,0
7/16/2020,Q3,5,H,China Ferry Terminal,Departure,0,0,0,0
7/16/2020,Q3,5,H,Harbour Control,Arrival,0,0,0,0
7/16/2020,Q3,5,H,Harbour Control,Departure,0,0,0,0
7/16/2020,Q3,5,H,Kai Tak Cruise Terminal,Arrival,0,0,0,0
7/16/2020,Q3,5,H,Kai Tak Cruise Terminal,Departure,0,0,0,0
7/16/2020,Q3,5,H,Macau Ferry Terminal,Arrival,0,0,0,0
7/16/2020,Q3,5,H,Macau Ferry Terminal,Departure,0,0,0,0
7/16/2020,Q3,5,H,Tuen Mun Ferry Terminal,Arrival,0,0,0,0
7/16/2020,Q3,5,H,Tuen Mun Ferry Terminal,Departure,0,0,0,0
7/17/2020,Q3,5,H,Airport,Arrival,1073,7,82,1162
7/17/2020,Q3,5,H,Airport,Departure,1209,51,72,1332
7/17/2020,Q3,5,H,Express Rail Link West Kowloon,Arrival,0,0,0,0
7/17/2020,Q3,5,H,Express Rail Link West Kowloon,Departure,0,0,0,0
7/17/2020,Q3,5,H,Hung Hom,Arrival,0,0,0,0
7/17/2020,Q3,5,H,Hung Hom,Departure,0,0,0,0
7/17/2020,Q3,5,H,Lo Wu,Arrival,0,0,0,0
7/17/2020,Q3,5,H,Lo Wu,Departure,0,0,0,0
7/17/2020,Q3,5,H,Lok Ma Chau Spur Line,Arrival,37,0,0,37
7/17/2020,Q3,5,H,Lok Ma Chau Spur Line,Departure,37,0,0,37
7/17/2020,Q3,5,H,Hong Kong-Zhuhai-Macao Bridge,Arrival,69,2,3,74
7/17/2020,Q3,5,H,Hong Kong-Zhuhai-Macao Bridge,Departure,94,1,3,98
7/17/2020,Q3,5,H,Lok Ma Chau,Arrival,0,0,0,0
7/17/2020,Q3,5,H,Lok Ma Chau,Departure,0,0,0,0
7/17/2020,Q3,5,H,Man Kam To,Arrival,0,0,0,0
7/17/2020,Q3,5,H,Man Kam To,Departure,0,0,0,0
7/17/2020,Q3,5,H,Sha Tau Kok,Arrival,0,0,0,0
7/17/2020,Q3,5,H,Sha Tau Kok,Departure,0,0,0,0
7/17/2020,Q3,5,H,Shenzhen Bay,Arrival,588,54,16,658
7/17/2020,Q3,5,H,Shenzhen Bay,Departure,360,45,11,416
7/17/2020,Q3,5,H,China Ferry Terminal,Arrival,0,0,0,0
7/17/2020,Q3,5,H,China Ferry Terminal,Departure,0,0,0,0
7/17/2020,Q3,5,H,Harbour Control,Arrival,0,0,0,0
7/17/2020,Q3,5,H,Harbour Control,Departure,0,0,0,0
7/17/2020,Q3,5,H,Kai Tak Cruise Terminal,Arrival,0,0,0,0
7/17/2020,Q3,5,H,Kai Tak Cruise Terminal,Departure,0,0,0,0
7/17/2020,Q3,5,H,Macau Ferry Terminal,Arrival,0,0,0,0
7/17/2020,Q3,5,H,Macau Ferry Terminal,Departure,0,0,0,0
7/17/2020,Q3,5,H,Tuen Mun Ferry Terminal,Arrival,0,0,0,0
7/17/2020,Q3,5,H,Tuen Mun Ferry Terminal,Departure,0,0,0,0
7/18/2020,Q3,5,H,Airport,Arrival,693,12,45,750
7/18/2020,Q3,5,H,Airport,Departure,1074,65,69,1208
7/18/2020,Q3,5,H,Express Rail Link West Kowloon,Arrival,0,0,0,0
7/18/2020,Q3,5,H,Express Rail Link West Kowloon,Departure,0,0,0,0
7/18/2020,Q3,5,H,Hung Hom,Arrival,0,0,0,0
7/18/2020,Q3,5,H,Hung Hom,Departure,0,0,0,0
7/18/2020,Q3,5,H,Lo Wu,Arrival,0,0,0,0
7/18/2020,Q3,5,H,Lo Wu,Departure,0,0,0,0
7/18/2020,Q3,5,H,Lok Ma Chau Spur Line,Arrival,0,0,0,0
7/18/2020,Q3,5,H,Lok Ma Chau Spur Line,Departure,0,0,0,0
7/18/2020,Q3,5,H,Hong Kong-Zhuhai-Macao Bridge,Arrival,58,3,5,66
7/18/2020,Q3,5,H,Hong Kong-Zhuhai-Macao Bridge,Departure,153,16,7,176
7/18/2020,Q3,5,H,Lok Ma Chau,Arrival,0,0,0,0
7/18/2020,Q3,5,H,Lok Ma Chau,Departure,0,0,0,0
7/18/2020,Q3,5,H,Man Kam To,Arrival,0,0,0,0
7/18/2020,Q3,5,H,Man Kam To,Departure,0,0,0,0
7/18/2020,Q3,5,H,Sha Tau Kok,Arrival,0,0,0,0
7/18/2020,Q3,5,H,Sha Tau Kok,Departure,0,0,0,0
7/18/2020,Q3,5,H,Shenzhen Bay,Arrival,472,75,4,551
7/18/2020,Q3,5,H,Shenzhen Bay,Departure,745,68,9,822
7/18/2020,Q3,5,H,China Ferry Terminal,Arrival,0,0,0,0
7/18/2020,Q3,5,H,China Ferry Terminal,Departure,0,0,0,0
7/18/2020,Q3,5,H,Harbour Control,Arrival,0,0,0,0
7/18/2020,Q3,5,H,Harbour Control,Departure,0,0,0,0
7/18/2020,Q3,5,H,Kai Tak Cruise Terminal,Arrival,0,0,0,0
7/18/2020,Q3,5,H,Kai Tak Cruise Terminal,Departure,0,0,0,0
7/18/2020,Q3,5,H,Macau Ferry Terminal,Arrival,0,0,0,0
7/18/2020,Q3,5,H,Macau Ferry Terminal,Departure,0,0,0,0
7/18/2020,Q3,5,H,Tuen Mun Ferry Terminal,Arrival,0,0,0,0
7/18/2020,Q3,5,H,Tuen Mun Ferry Terminal,Departure,0,0,0,0
7/19/2020,Q3,5,H,Airport,Arrival,912,2,42,956
7/19/2020,Q3,5,H,Airport,Departure,1428,73,109,1610
7/19/2020,Q3,5,H,Express Rail Link West Kowloon,Arrival,0,0,0,0
7/19/2020,Q3,5,H,Express Rail Link West Kowloon,Departure,0,0,0,0
7/19/2020,Q3,5,H,Hung Hom,Arrival,0,0,0,0
7/19/2020,Q3,5,H,Hung Hom,Departure,0,0,0,0
7/19/2020,Q3,5,H,Lo Wu,Arrival,0,0,0,0
7/19/2020,Q3,5,H,Lo Wu,Departure,0,0,0,0
7/19/2020,Q3,5,H,Lok Ma Chau Spur Line,Arrival,0,0,0,0
7/19/2020,Q3,5,H,Lok Ma Chau Spur Line,Departure,0,0,0,0
7/19/2020,Q3,5,H,Hong Kong-Zhuhai-Macao Bridge,Arrival,32,4,5,41
7/19/2020,Q3,5,H,Hong Kong-Zhuhai-Macao Bridge,Departure,141,5,4,150
7/19/2020,Q3,5,H,Lok Ma Chau,Arrival,0,0,0,0
7/19/2020,Q3,5,H,Lok Ma Chau,Departure,0,0,0,0
7/19/2020,Q3,5,H,Man Kam To,Arrival,0,0,0,0
7/19/2020,Q3,5,H,Man Kam To,Departure,0,0,0,0
7/19/2020,Q3,5,H,Sha Tau Kok,Arrival,0,0,0,0
7/19/2020,Q3,5,H,Sha Tau Kok,Departure,0,0,0,0
7/19/2020,Q3,5,H,Shenzhen Bay,Arrival,435,78,7,520
7/19/2020,Q3,5,H,Shenzhen Bay,Departure,674,109,7,790
7/19/2020,Q3,5,H,China Ferry Terminal,Arrival,0,0,0,0
7/19/2020,Q3,5,H,China Ferry Terminal,Departure,0,0,0,0
7/19/2020,Q3,5,H,Harbour Control,Arrival,0,0,0,0
7/19/2020,Q3,5,H,Harbour Control,Departure,0,0,0,0
7/19/2020,Q3,5,H,Kai Tak Cruise Terminal,Arrival,0,0,0,0
7/19/2020,Q3,5,H,Kai Tak Cruise Terminal,Departure,0,0,0,0
7/19/2020,Q3,5,H,Macau Ferry Terminal,Arrival,0,0,0,0
7/19/2020,Q3,5,H,Macau Ferry Terminal,Departure,0,0,0,0
7/19/2020,Q3,5,H,Tuen Mun Ferry Terminal,Arrival,0,0,0,0
7/19/2020,Q3,5,H,Tuen Mun Ferry Terminal,Departure,0,0,0,0
7/20/2020,Q3,5,H,Airport,Arrival,605,2,27,634
7/20/2020,Q3,5,H,Airport,Departure,794,41,113,948
7/20/2020,Q3,5,H,Express Rail Link West Kowloon,Arrival,0,0,0,0
7/20/2020,Q3,5,H,Express Rail Link West Kowloon,Departure,0,0,0,0
7/20/2020,Q3,5,H,Hung Hom,Arrival,0,0,0,0
7/20/2020,Q3,5,H,Hung Hom,Departure,0,0,0,0
7/20/2020,Q3,5,H,Lo Wu,Arrival,0,0,0,0
7/20/2020,Q3,5,H,Lo Wu,Departure,0,0,0,0
7/20/2020,Q3,5,H,Lok Ma Chau Spur Line,Arrival,0,0,0,0
7/20/2020,Q3,5,H,Lok Ma Chau Spur Line,Departure,0,0,0,0
7/20/2020,Q3,5,H,Hong Kong-Zhuhai-Macao Bridge,Arrival,45,3,2,50
7/20/2020,Q3,5,H,Hong Kong-Zhuhai-Macao Bridge,Departure,156,11,2,169
7/20/2020,Q3,5,H,Lok Ma Chau,Arrival,0,0,0,0
7/20/2020,Q3,5,H,Lok Ma Chau,Departure,0,0,0,0
7/20/2020,Q3,5,H,Man Kam To,Arrival,0,0,0,0
7/20/2020,Q3,5,H,Man Kam To,Departure,0,0,0,0
7/20/2020,Q3,5,H,Sha Tau Kok,Arrival,0,0,0,0
7/20/2020,Q3,5,H,Sha Tau Kok,Departure,0,0,0,0
7/20/2020,Q3,5,H,Shenzhen Bay,Arrival,535,68,12,615
7/20/2020,Q3,5,H,Shenzhen Bay,Departure,798,114,18,930
7/20/2020,Q3,5,H,China Ferry Terminal,Arrival,0,0,0,0
7/20/2020,Q3,5,H,China Ferry Terminal,Departure,0,0,0,0
7/20/2020,Q3,5,H,Harbour Control,Arrival,0,0,0,0
7/20/2020,Q3,5,H,Harbour Control,Departure,0,0,0,0
7/20/2020,Q3,5,H,Kai Tak Cruise Terminal,Arrival,0,0,0,0
7/20/2020,Q3,5,H,Kai Tak Cruise Terminal,Departure,0,0,0,0
7/20/2020,Q3,5,H,Macau Ferry Terminal,Arrival,0,0,0,0
7/20/2020,Q3,5,H,Macau Ferry Terminal,Departure,0,0,0,0
7/20/2020,Q3,5,H,Tuen Mun Ferry Terminal,Arrival,0,0,0,0
7/20/2020,Q3,5,H,Tuen Mun Ferry Terminal,Departure,0,0,0,0
7/21/2020,Q3,5,H,Airport,Arrival,728,3,49,780
7/21/2020,Q3,5,H,Airport,Departure,1501,95,72,1668
7/21/2020,Q3,5,H,Express Rail Link West Kowloon,Arrival,0,0,0,0
7/21/2020,Q3,5,H,Express Rail Link West Kowloon,Departure,0,0,0,0
7/21/2020,Q3,5,H,Hung Hom,Arrival,0,0,0,0
7/21/2020,Q3,5,H,Hung Hom,Departure,0,0,0,0
7/21/2020,Q3,5,H,Lo Wu,Arrival,0,0,0,0
7/21/2020,Q3,5,H,Lo Wu,Departure,0,0,0,0
7/21/2020,Q3,5,H,Lok Ma Chau Spur Line,Arrival,0,0,0,0
7/21/2020,Q3,5,H,Lok Ma Chau Spur Line,Departure,0,0,0,0
7/21/2020,Q3,5,H,Hong Kong-Zhuhai-Macao Bridge,Arrival,35,2,0,37
7/21/2020,Q3,5,H,Hong Kong-Zhuhai-Macao Bridge,Departure,200,12,3,215
7/21/2020,Q3,5,H,Lok Ma Chau,Arrival,0,0,0,0
7/21/2020,Q3,5,H,Lok Ma Chau,Departure,0,0,0,0
7/21/2020,Q3,5,H,Man Kam To,Arrival,0,0,0,0
7/21/2020,Q3,5,H,Man Kam To,Departure,0,0,0,0
7/21/2020,Q3,5,H,Sha Tau Kok,Arrival,0,0,0,0
7/21/2020,Q3,5,H,Sha Tau Kok,Departure,0,0,0,0
7/21/2020,Q3,5,H,Shenzhen Bay,Arrival,386,45,6,437
7/21/2020,Q3,5,H,Shenzhen Bay,Departure,1126,141,18,1285
7/21/2020,Q3,5,H,China Ferry Terminal,Arrival,0,0,0,0
7/21/2020,Q3,5,H,China Ferry Terminal,Departure,0,0,0,0
7/21/2020,Q3,5,H,Harbour Control,Arrival,0,0,0,0
7/21/2020,Q3,5,H,Harbour Control,Departure,0,0,0,0
7/21/2020,Q3,5,H,Kai Tak Cruise Terminal,Arrival,0,0,0,0
7/21/2020,Q3,5,H,Kai Tak Cruise Terminal,Departure,0,0,0,0
7/21/2020,Q3,5,H,Macau Ferry Terminal,Arrival,0,0,0,0
7/21/2020,Q3,5,H,Macau Ferry Terminal,Departure,0,0,0,0
7/21/2020,Q3,5,H,Tuen Mun Ferry Terminal,Arrival,0,0,0,0
7/21/2020,Q3,5,H,Tuen Mun Ferry Terminal,Departure,0,0,0,0
7/22/2020,Q3,5,H,Airport,Arrival,1089,3,47,1139
7/22/2020,Q3,5,H,Airport,Departure,1064,41,68,1173
7/22/2020,Q3,5,H,Express Rail Link West Kowloon,Arrival,0,0,0,0
7/22/2020,Q3,5,H,Express Rail Link West Kowloon,Departure,0,0,0,0
7/22/2020,Q3,5,H,Hung Hom,Arrival,0,0,0,0
7/22/2020,Q3,5,H,Hung Hom,Departure,0,0,0,0
7/22/2020,Q3,5,H,Lo Wu,Arrival,0,0,0,0
7/22/2020,Q3,5,H,Lo Wu,Departure,0,0,0,0
7/22/2020,Q3,5,H,Lok Ma Chau Spur Line,Arrival,0,0,0,0
7/22/2020,Q3,5,H,Lok Ma Chau Spur Line,Departure,0,0,0,0
7/22/2020,Q3,5,H,Hong Kong-Zhuhai-Macao Bridge,Arrival,47,1,5,53
7/22/2020,Q3,5,H,Hong Kong-Zhuhai-Macao Bridge,Departure,279,26,5,310
7/22/2020,Q3,5,H,Lok Ma Chau,Arrival,0,0,0,0
7/22/2020,Q3,5,H,Lok Ma Chau,Departure,0,0,0,0
7/22/2020,Q3,5,H,Man Kam To,Arrival,0,0,0,0
7/22/2020,Q3,5,H,Man Kam To,Departure,0,0,0,0
7/22/2020,Q3,5,H,Sha Tau Kok,Arrival,0,0,0,0
7/22/2020,Q3,5,H,Sha Tau Kok,Departure,0,0,0,0
7/22/2020,Q3,5,H,Shenzhen Bay,Arrival,326,46,6,378
7/22/2020,Q3,5,H,Shenzhen Bay,Departure,1702,215,10,1927
7/22/2020,Q3,5,H,China Ferry Terminal,Arrival,0,0,0,0
7/22/2020,Q3,5,H,China Ferry Terminal,Departure,0,0,0,0
7/22/2020,Q3,5,H,Harbour Control,Arrival,0,0,0,0
7/22/2020,Q3,5,H,Harbour Control,Departure,0,0,0,0
7/22/2020,Q3,5,H,Kai Tak Cruise Terminal,Arrival,0,0,0,0
7/22/2020,Q3,5,H,Kai Tak Cruise Terminal,Departure,0,0,0,0
7/22/2020,Q3,5,H,Macau Ferry Terminal,Arrival,0,0,0,0
7/22/2020,Q3,5,H,Macau Ferry Terminal,Departure,0,0,0,0
7/22/2020,Q3,5,H,Tuen Mun Ferry Terminal,Arrival,0,0,0,0
7/22/2020,Q3,5,H,Tuen Mun Ferry Terminal,Departure,0,0,0,0
7/23/2020,Q3,5,H,Airport,Arrival,453,5,11,469
7/23/2020,Q3,5,H,Airport,Departure,1165,32,195,1392
7/23/2020,Q3,5,H,Express Rail Link West Kowloon,Arrival,0,0,0,0
7/23/2020,Q3,5,H,Express Rail Link West Kowloon,Departure,0,0,0,0
7/23/2020,Q3,5,H,Hung Hom,Arrival,0,0,0,0
7/23/2020,Q3,5,H,Hung Hom,Departure,0,0,0,0
7/23/2020,Q3,5,H,Lo Wu,Arrival,0,0,0,0
7/23/2020,Q3,5,H,Lo Wu,Departure,0,0,0,0
7/23/2020,Q3,5,H,Lok Ma Chau Spur Line,Arrival,0,0,0,0
7/23/2020,Q3,5,H,Lok Ma Chau Spur Line,Departure,0,0,0,0
7/23/2020,Q3,5,H,Hong Kong-Zhuhai-Macao Bridge,Arrival,37,1,8,46
7/23/2020,Q3,5,H,Hong Kong-Zhuhai-Macao Bridge,Departure,252,20,5,277
7/23/2020,Q3,5,H,Lok Ma Chau,Arrival,0,0,0,0
7/23/2020,Q3,5,H,Lok Ma Chau,Departure,0,0,0,0
7/23/2020,Q3,5,H,Man Kam To,Arrival,0,0,0,0
7/23/2020,Q3,5,H,Man Kam To,Departure,0,0,0,0
7/23/2020,Q3,5,H,Sha Tau Kok,Arrival,0,0,0,0
7/23/2020,Q3,5,H,Sha Tau Kok,Departure,0,0,0,0
7/23/2020,Q3,5,H,Shenzhen Bay,Arrival,301,37,20,358
7/23/2020,Q3,5,H,Shenzhen Bay,Departure,1590,210,16,1816
7/23/2020,Q3,5,H,China Ferry Terminal,Arrival,0,0,0,0
7/23/2020,Q3,5,H,China Ferry Terminal,Departure,0,0,0,0
7/23/2020,Q3,5,H,Harbour Control,Arrival,0,0,0,0
7/23/2020,Q3,5,H,Harbour Control,Departure,0,0,0,0
7/23/2020,Q3,5,H,Kai Tak Cruise Terminal,Arrival,0,0,0,0
7/23/2020,Q3,5,H,Kai Tak Cruise Terminal,Departure,0,0,0,0
7/23/2020,Q3,5,H,Macau Ferry Terminal,Arrival,0,0,0,0
7/23/2020,Q3,5,H,Macau Ferry Terminal,Departure,0,0,0,0
7/23/2020,Q3,5,H,Tuen Mun Ferry Terminal,Arrival,0,0,0,0
7/23/2020,Q3,5,H,Tuen Mun Ferry Terminal,Departure,0,0,0,0
7/24/2020,Q3,5,H,Airport,Arrival,1069,5,42,1116
7/24/2020,Q3,5,H,Airport,Departure,1386,56,101,1543
7/24/2020,Q3,5,H,Express Rail Link West Kowloon,Arrival,0,0,0,0
7/24/2020,Q3,5,H,Express Rail Link West Kowloon,Departure,0,0,0,0
7/24/2020,Q3,5,H,Hung Hom,Arrival,0,0,0,0
7/24/2020,Q3,5,H,Hung Hom,Departure,0,0,0,0
7/24/2020,Q3,5,H,Lo Wu,Arrival,0,0,0,0
7/24/2020,Q3,5,H,Lo Wu,Departure,0,0,0,0
7/24/2020,Q3,5,H,Lok Ma Chau Spur Line,Arrival,0,0,0,0
7/24/2020,Q3,5,H,Lok Ma Chau Spur Line,Departure,0,0,0,0
7/24/2020,Q3,5,H,Hong Kong-Zhuhai-Macao Bridge,Arrival,36,0,2,38
7/24/2020,Q3,5,H,Hong Kong-Zhuhai-Macao Bridge,Departure,250,18,13,281
7/24/2020,Q3,5,H,Lok Ma Chau,Arrival,0,0,0,0
7/24/2020,Q3,5,H,Lok Ma Chau,Departure,0,0,0,0
7/24/2020,Q3,5,H,Man Kam To,Arrival,0,0,0,0
7/24/2020,Q3,5,H,Man Kam To,Departure,0,0,0,0
7/24/2020,Q3,5,H,Sha Tau Kok,Arrival,0,0,0,0
7/24/2020,Q3,5,H,Sha Tau Kok,Departure,0,0,0,0
7/24/2020,Q3,5,H,Shenzhen Bay,Arrival,277,48,0,325
7/24/2020,Q3,5,H,Shenzhen Bay,Departure,1853,234,16,2103
7/24/2020,Q3,5,H,China Ferry Terminal,Arrival,0,0,0,0
7/24/2020,Q3,5,H,China Ferry Terminal,Departure,0,0,0,0
7/24/2020,Q3,5,H,Harbour Control,Arrival,0,0,0,0
7/24/2020,Q3,5,H,Harbour Control,Departure,0,0,0,0
7/24/2020,Q3,5,H,Kai Tak Cruise Terminal,Arrival,0,0,0,0
7/24/2020,Q3,5,H,Kai Tak Cruise Terminal,Departure,0,0,0,0
7/24/2020,Q3,5,H,Macau Ferry Terminal,Arrival,0,0,0,0
7/24/2020,Q3,5,H,Macau Ferry Terminal,Departure,0,0,0,0
7/24/2020,Q3,5,H,Tuen Mun Ferry Terminal,Arrival,0,0,0,0
7/24/2020,Q3,5,H,Tuen Mun Ferry Terminal,Departure,0,0,0,0
7/25/2020,Q3,5,H,Airport,Arrival,577,6,21,604
7/25/2020,Q3,5,H,Airport,Departure,1280,68,55,1403
7/25/2020,Q3,5,H,Express Rail Link West Kowloon,Arrival,0,0,0,0
7/25/2020,Q3,5,H,Express Rail Link West Kowloon,Departure,0,0,0,0
7/25/2020,Q3,5,H,Hung Hom,Arrival,0,0,0,0
7/25/2020,Q3,5,H,Hung Hom,Departure,0,0,0,0
7/25/2020,Q3,5,H,Lo Wu,Arrival,0,0,0,0
7/25/2020,Q3,5,H,Lo Wu,Departure,0,0,0,0
7/25/2020,Q3,5,H,Lok Ma Chau Spur Line,Arrival,0,0,0,0
7/25/2020,Q3,5,H,Lok Ma Chau Spur Line,Departure,0,0,0,0
7/25/2020,Q3,5,H,Hong Kong-Zhuhai-Macao Bridge,Arrival,29,2,1,32
7/25/2020,Q3,5,H,Hong Kong-Zhuhai-Macao Bridge,Departure,252,17,4,273
7/25/2020,Q3,5,H,Lok Ma Chau,Arrival,0,0,0,0
7/25/2020,Q3,5,H,Lok Ma Chau,Departure,0,0,0,0
7/25/2020,Q3,5,H,Man Kam To,Arrival,0,0,0,0
7/25/2020,Q3,5,H,Man Kam To,Departure,0,0,0,0
7/25/2020,Q3,5,H,Sha Tau Kok,Arrival,0,0,0,0
7/25/2020,Q3,5,H,Sha Tau Kok,Departure,0,0,0,0
7/25/2020,Q3,5,H,Shenzhen Bay,Arrival,300,51,5,356
7/25/2020,Q3,5,H,Shenzhen Bay,Departure,1945,256,6,2207
7/25/2020,Q3,5,H,China Ferry Terminal,Arrival,0,0,0,0
7/25/2020,Q3,5,H,China Ferry Terminal,Departure,0,0,0,0
7/25/2020,Q3,5,H,Harbour Control,Arrival,0,0,0,0
7/25/2020,Q3,5,H,Harbour Control,Departure,0,0,0,0
7/25/2020,Q3,5,H,Kai Tak Cruise Terminal,Arrival,0,0,0,0
7/25/2020,Q3,5,H,Kai Tak Cruise Terminal,Departure,0,0,0,0
7/25/2020,Q3,5,H,Macau Ferry Terminal,Arrival,0,0,0,0
7/25/2020,Q3,5,H,Macau Ferry Terminal,Departure,0,0,0,0
7/25/2020,Q3,5,H,Tuen Mun Ferry Terminal,Arrival,0,0,0,0
7/25/2020,Q3,5,H,Tuen Mun Ferry Terminal,Departure,0,0,0,0
7/26/2020,Q3,5,H,Airport,Arrival,759,4,49,812
7/26/2020,Q3,5,H,Airport,Departure,1653,85,73,1811
7/26/2020,Q3,5,H,Express Rail Link West Kowloon,Arrival,0,0,0,0
7/26/2020,Q3,5,H,Express Rail Link West Kowloon,Departure,0,0,0,0
7/26/2020,Q3,5,H,Hung Hom,Arrival,0,0,0,0
7/26/2020,Q3,5,H,Hung Hom,Departure,0,0,0,0
7/26/2020,Q3,5,H,Lo Wu,Arrival,0,0,0,0
7/26/2020,Q3,5,H,Lo Wu,Departure,0,0,0,0
7/26/2020,Q3,5,H,Lok Ma Chau Spur Line,Arrival,0,0,0,0
7/26/2020,Q3,5,H,Lok Ma Chau Spur Line,Departure,0,0,0,0
7/26/2020,Q3,5,H,Hong Kong-Zhuhai-Macao Bridge,Arrival,14,1,6,21
7/26/2020,Q3,5,H,Hong Kong-Zhuhai-Macao Bridge,Departure,244,20,4,268
7/26/2020,Q3,5,H,Lok Ma Chau,Arrival,0,0,0,0
7/26/2020,Q3,5,H,Lok Ma Chau,Departure,0,0,0,0
7/26/2020,Q3,5,H,Man Kam To,Arrival,0,0,0,0
7/26/2020,Q3,5,H,Man Kam To,Departure,0,0,0,0
7/26/2020,Q3,5,H,Sha Tau Kok,Arrival,0,0,0,0
7/26/2020,Q3,5,H,Sha Tau Kok,Departure,0,0,0,0
7/26/2020,Q3,5,H,Shenzhen Bay,Arrival,280,33,8,321
7/26/2020,Q3,5,H,Shenzhen Bay,Departure,999,113,7,1119
7/26/2020,Q3,5,H,China Ferry Terminal,Arrival,0,0,0,0
7/26/2020,Q3,5,H,China Ferry Terminal,Departure,0,0,0,0
7/26/2020,Q3,5,H,Harbour Control,Arrival,0,0,0,0
7/26/2020,Q3,5,H,Harbour Control,Departure,0,0,0,0
7/26/2020,Q3,5,H,Kai Tak Cruise Terminal,Arrival,0,0,0,0
7/26/2020,Q3,5,H,Kai Tak Cruise Terminal,Departure,0,0,0,0
7/26/2020,Q3,5,H,Macau Ferry Terminal,Arrival,0,0,0,0
7/26/2020,Q3,5,H,Macau Ferry Terminal,Departure,0,0,0,0
7/26/2020,Q3,5,H,Tuen Mun Ferry Terminal,Arrival,0,0,0,0
7/26/2020,Q3,5,H,Tuen Mun Ferry Terminal,Departure,0,0,0,0
7/27/2020,Q3,5,H,Airport,Arrival,517,5,25,547
7/27/2020,Q3,5,H,Airport,Departure,575,33,42,650
7/27/2020,Q3,5,H,Express Rail Link West Kowloon,Arrival,0,0,0,0
7/27/2020,Q3,5,H,Express Rail Link West Kowloon,Departure,0,0,0,0
7/27/2020,Q3,5,H,Hung Hom,Arrival,0,0,0,0
7/27/2020,Q3,5,H,Hung Hom,Departure,0,0,0,0
7/27/2020,Q3,5,H,Lo Wu,Arrival,0,0,0,0
7/27/2020,Q3,5,H,Lo Wu,Departure,0,0,0,0
7/27/2020,Q3,5,H,Lok Ma Chau Spur Line,Arrival,0,0,0,0
7/27/2020,Q3,5,H,Lok Ma Chau Spur Line,Departure,0,0,0,0
7/27/2020,Q3,5,H,Hong Kong-Zhuhai-Macao Bridge,Arrival,21,3,4,28
7/27/2020,Q3,5,H,Hong Kong-Zhuhai-Macao Bridge,Departure,117,3,7,127
7/27/2020,Q3,5,H,Lok Ma Chau,Arrival,0,0,0,0
7/27/2020,Q3,5,H,Lok Ma Chau,Departure,0,0,0,0
7/27/2020,Q3,5,H,Man Kam To,Arrival,0,0,0,0
7/27/2020,Q3,5,H,Man Kam To,Departure,0,0,0,0
7/27/2020,Q3,5,H,Sha Tau Kok,Arrival,0,0,0,0
7/27/2020,Q3,5,H,Sha Tau Kok,Departure,0,0,0,0
7/27/2020,Q3,5,H,Shenzhen Bay,Arrival,286,35,6,327
7/27/2020,Q3,5,H,Shenzhen Bay,Departure,578,86,5,669
7/27/2020,Q3,5,H,China Ferry Terminal,Arrival,0,0,0,0
7/27/2020,Q3,5,H,China Ferry Terminal,Departure,0,0,0,0
7/27/2020,Q3,5,H,Harbour Control,Arrival,0,0,0,0
7/27/2020,Q3,5,H,Harbour Control,Departure,0,0,0,0
7/27/2020,Q3,5,H,Kai Tak Cruise Terminal,Arrival,0,0,0,0
7/27/2020,Q3,5,H,Kai Tak Cruise Terminal,Departure,0,0,0,0
7/27/2020,Q3,5,H,Macau Ferry Terminal,Arrival,0,0,0,0
7/27/2020,Q3,5,H,Macau Ferry Terminal,Departure,0,0,0,0
7/27/2020,Q3,5,H,Tuen Mun Ferry Terminal,Arrival,0,0,0,0
7/27/2020,Q3,5,H,Tuen Mun Ferry Terminal,Departure,0,0,0,0
7/28/2020,Q3,5,H,Airport,Arrival,869,10,47,926
7/28/2020,Q3,5,H,Airport,Departure,1379,62,84,1525
7/28/2020,Q3,5,H,Express Rail Link West Kowloon,Arrival,0,0,0,0
7/28/2020,Q3,5,H,Express Rail Link West Kowloon,Departure,0,0,0,0
7/28/2020,Q3,5,H,Hung Hom,Arrival,0,0,0,0
7/28/2020,Q3,5,H,Hung Hom,Departure,0,0,0,0
7/28/2020,Q3,5,H,Lo Wu,Arrival,0,0,0,0
7/28/2020,Q3,5,H,Lo Wu,Departure,0,0,0,0
7/28/2020,Q3,5,H,Lok Ma Chau Spur Line,Arrival,0,0,0,0
7/28/2020,Q3,5,H,Lok Ma Chau Spur Line,Departure,0,0,0,0
7/28/2020,Q3,5,H,Hong Kong-Zhuhai-Macao Bridge,Arrival,21,0,8,29
7/28/2020,Q3,5,H,Hong Kong-Zhuhai-Macao Bridge,Departure,222,12,1,235
7/28/2020,Q3,5,H,Lok Ma Chau,Arrival,0,0,0,0
7/28/2020,Q3,5,H,Lok Ma Chau,Departure,0,0,0,0
7/28/2020,Q3,5,H,Man Kam To,Arrival,0,0,0,0
7/28/2020,Q3,5,H,Man Kam To,Departure,0,0,0,0
7/28/2020,Q3,5,H,Sha Tau Kok,Arrival,0,0,0,0
7/28/2020,Q3,5,H,Sha Tau Kok,Departure,0,0,0,0
7/28/2020,Q3,5,H,Shenzhen Bay,Arrival,281,37,9,327
7/28/2020,Q3,5,H,Shenzhen Bay,Departure,1098,125,6,1229
7/28/2020,Q3,5,H,China Ferry Terminal,Arrival,0,0,0,0
7/28/2020,Q3,5,H,China Ferry Terminal,Departure,0,0,0,0
7/28/2020,Q3,5,H,Harbour Control,Arrival,0,0,0,0
7/28/2020,Q3,5,H,Harbour Control,Departure,0,0,0,0
7/28/2020,Q3,5,H,Kai Tak Cruise Terminal,Arrival,0,0,0,0
7/28/2020,Q3,5,H,Kai Tak Cruise Terminal,Departure,0,0,0,0
7/28/2020,Q3,5,H,Macau Ferry Terminal,Arrival,0,0,0,0
7/28/2020,Q3,5,H,Macau Ferry Terminal,Departure,0,0,0,0
7/28/2020,Q3,5,H,Tuen Mun Ferry Terminal,Arrival,0,0,0,0
7/28/2020,Q3,5,H,Tuen Mun Ferry Terminal,Departure,0,0,0,0
7/29/2020,Q3,5,H,Airport,Arrival,333,0,23,356
7/29/2020,Q3,5,H,Airport,Departure,1143,28,53,1224
7/29/2020,Q3,5,H,Express Rail Link West Kowloon,Arrival,0,0,0,0
7/29/2020,Q3,5,H,Express Rail Link West Kowloon,Departure,0,0,0,0
7/29/2020,Q3,5,H,Hung Hom,Arrival,0,0,0,0
7/29/2020,Q3,5,H,Hung Hom,Departure,0,0,0,0
7/29/2020,Q3,5,H,Lo Wu,Arrival,0,0,0,0
7/29/2020,Q3,5,H,Lo Wu,Departure,0,0,0,0
7/29/2020,Q3,5,H,Lok Ma Chau Spur Line,Arrival,0,0,0,0
7/29/2020,Q3,5,H,Lok Ma Chau Spur Line,Departure,0,0,0,0
7/29/2020,Q3,5,H,Hong Kong-Zhuhai-Macao Bridge,Arrival,36,0,7,43
7/29/2020,Q3,5,H,Hong Kong-Zhuhai-Macao Bridge,Departure,291,16,6,313
7/29/2020,Q3,5,H,Lok Ma Chau,Arrival,0,0,0,0
7/29/2020,Q3,5,H,Lok Ma Chau,Departure,0,0,0,0
7/29/2020,Q3,5,H,Man Kam To,Arrival,0,0,0,0
7/29/2020,Q3,5,H,Man Kam To,Departure,0,0,0,0
7/29/2020,Q3,5,H,Sha Tau Kok,Arrival,0,0,0,0
7/29/2020,Q3,5,H,Sha Tau Kok,Departure,0,0,0,0
7/29/2020,Q3,5,H,Shenzhen Bay,Arrival,306,25,4,335
7/29/2020,Q3,5,H,Shenzhen Bay,Departure,2295,267,14,2576
7/29/2020,Q3,5,H,China Ferry Terminal,Arrival,0,0,0,0
7/29/2020,Q3,5,H,China Ferry Terminal,Departure,0,0,0,0
7/29/2020,Q3,5,H,Harbour Control,Arrival,0,0,0,0
7/29/2020,Q3,5,H,Harbour Control,Departure,0,0,0,0
7/29/2020,Q3,5,H,Kai Tak Cruise Terminal,Arrival,0,0,0,0
7/29/2020,Q3,5,H,Kai Tak Cruise Terminal,Departure,0,0,0,0
7/29/2020,Q3,5,H,Macau Ferry Terminal,Arrival,0,0,0,0
7/29/2020,Q3,5,H,Macau Ferry Terminal,Departure,0,0,0,0
7/29/2020,Q3,5,H,Tuen Mun Ferry Terminal,Arrival,0,0,0,0
7/29/2020,Q3,5,H,Tuen Mun Ferry Terminal,Departure,0,0,0,0
7/30/2020,Q3,5,H,Airport,Arrival,250,3,20,273
7/30/2020,Q3,5,H,Airport,Departure,779,23,36,838
7/30/2020,Q3,5,H,Express Rail Link West Kowloon,Arrival,0,0,0,0
7/30/2020,Q3,5,H,Express Rail Link West Kowloon,Departure,0,0,0,0
7/30/2020,Q3,5,H,Hung Hom,Arrival,0,0,0,0
7/30/2020,Q3,5,H,Hung Hom,Departure,0,0,0,0
7/30/2020,Q3,5,H,Lo Wu,Arrival,0,0,0,0
7/30/2020,Q3,5,H,Lo Wu,Departure,0,0,0,0
7/30/2020,Q3,5,H,Lok Ma Chau Spur Line,Arrival,0,0,0,0
7/30/2020,Q3,5,H,Lok Ma Chau Spur Line,Departure,0,0,0,0
7/30/2020,Q3,5,H,Hong Kong-Zhuhai-Macao Bridge,Arrival,39,2,1,42
7/30/2020,Q3,5,H,Hong Kong-Zhuhai-Macao Bridge,Departure,321,20,9,350
7/30/2020,Q3,5,H,Lok Ma Chau,Arrival,0,0,0,0
7/30/2020,Q3,5,H,Lok Ma Chau,Departure,0,0,0,0
7/30/2020,Q3,5,H,Man Kam To,Arrival,0,0,0,0
7/30/2020,Q3,5,H,Man Kam To,Departure,0,0,0,0
7/30/2020,Q3,5,H,Sha Tau Kok,Arrival,0,0,0,0
7/30/2020,Q3,5,H,Sha Tau Kok,Departure,0,0,0,0
7/30/2020,Q3,5,H,Shenzhen Bay,Arrival,309,36,3,348
7/30/2020,Q3,5,H,Shenzhen Bay,Departure,1941,228,3,2172
7/30/2020,Q3,5,H,China Ferry Terminal,Arrival,0,0,0,0
7/30/2020,Q3,5,H,China Ferry Terminal,Departure,0,0,0,0
7/30/2020,Q3,5,H,Harbour Control,Arrival,0,0,0,0
7/30/2020,Q3,5,H,Harbour Control,Departure,0,0,0,0
7/30/2020,Q3,5,H,Kai Tak Cruise Terminal,Arrival,0,0,0,0
7/30/2020,Q3,5,H,Kai Tak Cruise Terminal,Departure,0,0,0,0
7/30/2020,Q3,5,H,Macau Ferry Terminal,Arrival,0,0,0,0
7/30/2020,Q3,5,H,Macau Ferry Terminal,Departure,0,0,0,0
7/30/2020,Q3,5,H,Tuen Mun Ferry Terminal,Arrival,0,0,0,0
7/30/2020,Q3,5,H,Tuen Mun Ferry Terminal,Departure,0,0,0,0
7/31/2020,Q3,5,H,Airport,Arrival,568,3,65,636
7/31/2020,Q3,5,H,Airport,Departure,1681,57,98,1836
7/31/2020,Q3,5,H,Express Rail Link West Kowloon,Arrival,0,0,0,0
7/31/2020,Q3,5,H,Express Rail Link West Kowloon,Departure,0,0,0,0
7/31/2020,Q3,5,H,Hung Hom,Arrival,0,0,0,0
7/31/2020,Q3,5,H,Hung Hom,Departure,0,0,0,0
7/31/2020,Q3,5,H,Lo Wu,Arrival,0,0,0,0
7/31/2020,Q3,5,H,Lo Wu,Departure,0,0,0,0
7/31/2020,Q3,5,H,Lok Ma Chau Spur Line,Arrival,0,0,0,0
7/31/2020,Q3,5,H,Lok Ma Chau Spur Line,Departure,0,0,0,0
7/31/2020,Q3,5,H,Hong Kong-Zhuhai-Macao Bridge,Arrival,56,1,4,61
7/31/2020,Q3,5,H,Hong Kong-Zhuhai-Macao Bridge,Departure,288,14,5,307
7/31/2020,Q3,5,H,Lok Ma Chau,Arrival,0,0,0,0
7/31/2020,Q3,5,H,Lok Ma Chau,Departure,0,0,0,0
7/31/2020,Q3,5,H,Man Kam To,Arrival,0,0,0,0
7/31/2020,Q3,5,H,Man Kam To,Departure,0,0,0,0
7/31/2020,Q3,5,H,Sha Tau Kok,Arrival,0,0,0,0
7/31/2020,Q3,5,H,Sha Tau Kok,Departure,0,0,0,0
7/31/2020,Q3,5,H,Shenzhen Bay,Arrival,359,39,4,402
7/31/2020,Q3,5,H,Shenzhen Bay,Departure,2336,301,4,2641
7/31/2020,Q3,5,H,China Ferry Terminal,Arrival,0,0,0,0
7/31/2020,Q3,5,H,China Ferry Terminal,Departure,0,0,0,0
7/31/2020,Q3,5,H,Harbour Control,Arrival,0,0,0,0
7/31/2020,Q3,5,H,Harbour Control,Departure,0,0,0,0
7/31/2020,Q3,5,H,Kai Tak Cruise Terminal,Arrival,0,0,0,0
7/31/2020,Q3,5,H,Kai Tak Cruise Terminal,Departure,0,0,0,0
7/31/2020,Q3,5,H,Macau Ferry Terminal,Arrival,0,0,0,0
7/31/2020,Q3,5,H,Macau Ferry Terminal,Departure,0,0,0,0
7/31/2020,Q3,5,H,Tuen Mun Ferry Terminal,Arrival,0,0,0,0
7/31/2020,Q3,5,H,Tuen Mun Ferry Terminal,Departure,0,0,0,0
8/1/2020,Q3,5,H,Airport,Arrival,571,5,11,587
8/1/2020,Q3,5,H,Airport,Departure,1800,80,82,1962
8/1/2020,Q3,5,H,Express Rail Link West Kowloon,Arrival,0,0,0,0
8/1/2020,Q3,5,H,Express Rail Link West Kowloon,Departure,0,0,0,0
8/1/2020,Q3,5,H,Hung Hom,Arrival,0,0,0,0
8/1/2020,Q3,5,H,Hung Hom,Departure,0,0,0,0
8/1/2020,Q3,5,H,Lo Wu,Arrival,0,0,0,0
8/1/2020,Q3,5,H,Lo Wu,Departure,0,0,0,0
8/1/2020,Q3,5,H,Lok Ma Chau Spur Line,Arrival,0,0,0,0
8/1/2020,Q3,5,H,Lok Ma Chau Spur Line,Departure,0,0,0,0
8/1/2020,Q3,5,H,Hong Kong-Zhuhai-Macao Bridge,Arrival,29,1,4,34
8/1/2020,Q3,5,H,Hong Kong-Zhuhai-Macao Bridge,Departure,242,21,4,267
8/1/2020,Q3,5,H,Lok Ma Chau,Arrival,0,0,0,0
8/1/2020,Q3,5,H,Lok Ma Chau,Departure,0,0,0,0
8/1/2020,Q3,5,H,Man Kam To,Arrival,0,0,0,0
8/1/2020,Q3,5,H,Man Kam To,Departure,0,0,0,0
8/1/2020,Q3,5,H,Sha Tau Kok,Arrival,0,0,0,0
8/1/2020,Q3,5,H,Sha Tau Kok,Departure,0,0,0,0
8/1/2020,Q3,5,H,Shenzhen Bay,Arrival,350,50,4,404
8/1/2020,Q3,5,H,Shenzhen Bay,Departure,1861,219,10,2090
8/1/2020,Q3,5,H,China Ferry Terminal,Arrival,0,0,0,0
8/1/2020,Q3,5,H,China Ferry Terminal,Departure,0,0,0,0
8/1/2020,Q3,5,H,Harbour Control,Arrival,0,0,0,0
8/1/2020,Q3,5,H,Harbour Control,Departure,0,0,0,0
8/1/2020,Q3,5,H,Kai Tak Cruise Terminal,Arrival,0,0,0,0
8/1/2020,Q3,5,H,Kai Tak Cruise Terminal,Departure,0,0,0,0
8/1/2020,Q3,5,H,Macau Ferry Terminal,Arrival,0,0,0,0
8/1/2020,Q3,5,H,Macau Ferry Terminal,Departure,0,0,0,0
8/1/2020,Q3,5,H,Tuen Mun Ferry Terminal,Arrival,0,0,0,0
8/1/2020,Q3,5,H,Tuen Mun Ferry Terminal,Departure,0,0,0,0
8/2/2020,Q3,5,H,Airport,Arrival,674,3,46,723
8/2/2020,Q3,5,H,Airport,Departure,1663,59,96,1818
8/2/2020,Q3,5,H,Express Rail Link West Kowloon,Arrival,0,0,0,0
8/2/2020,Q3,5,H,Express Rail Link West Kowloon,Departure,0,0,0,0
8/2/2020,Q3,5,H,Hung Hom,Arrival,0,0,0,0
8/2/2020,Q3,5,H,Hung Hom,Departure,0,0,0,0
8/2/2020,Q3,5,H,Lo Wu,Arrival,0,0,0,0
8/2/2020,Q3,5,H,Lo Wu,Departure,0,0,0,0
8/2/2020,Q3,5,H,Lok Ma Chau Spur Line,Arrival,0,0,0,0
8/2/2020,Q3,5,H,Lok Ma Chau Spur Line,Departure,0,0,0,0
8/2/2020,Q3,5,H,Hong Kong-Zhuhai-Macao Bridge,Arrival,32,2,8,42
8/2/2020,Q3,5,H,Hong Kong-Zhuhai-Macao Bridge,Departure,233,19,0,252
8/2/2020,Q3,5,H,Lok Ma Chau,Arrival,0,0,0,0
8/2/2020,Q3,5,H,Lok Ma Chau,Departure,0,0,0,0
8/2/2020,Q3,5,H,Man Kam To,Arrival,0,0,0,0
8/2/2020,Q3,5,H,Man Kam To,Departure,0,0,0,0
8/2/2020,Q3,5,H,Sha Tau Kok,Arrival,0,0,0,0
8/2/2020,Q3,5,H,Sha Tau Kok,Departure,0,0,0,0
8/2/2020,Q3,5,H,Shenzhen Bay,Arrival,338,29,5,372
8/2/2020,Q3,5,H,Shenzhen Bay,Departure,1032,106,4,1142
8/2/2020,Q3,5,H,China Ferry Terminal,Arrival,0,0,0,0
8/2/2020,Q3,5,H,China Ferry Terminal,Departure,0,0,0,0
8/2/2020,Q3,5,H,Harbour Control,Arrival,0,0,0,0
8/2/2020,Q3,5,H,Harbour Control,Departure,0,0,0,0
8/2/2020,Q3,5,H,Kai Tak Cruise Terminal,Arrival,0,0,0,0
8/2/2020,Q3,5,H,Kai Tak Cruise Terminal,Departure,0,0,0,0
8/2/2020,Q3,5,H,Macau Ferry Terminal,Arrival,0,0,0,0
8/2/2020,Q3,5,H,Macau Ferry Terminal,Departure,0,0,0,0
8/2/2020,Q3,5,H,Tuen Mun Ferry Terminal,Arrival,0,0,0,0
8/2/2020,Q3,5,H,Tuen Mun Ferry Terminal,Departure,0,0,0,0
8/3/2020,Q3,5,H,Airport,Arrival,416,2,14,432
8/3/2020,Q3,5,H,Airport,Departure,883,24,112,1019
8/3/2020,Q3,5,H,Express Rail Link West Kowloon,Arrival,0,0,0,0
8/3/2020,Q3,5,H,Express Rail Link West Kowloon,Departure,0,0,0,0
8/3/2020,Q3,5,H,Hung Hom,Arrival,0,0,0,0
8/3/2020,Q3,5,H,Hung Hom,Departure,0,0,0,0
8/3/2020,Q3,5,H,Lo Wu,Arrival,0,0,0,0
8/3/2020,Q3,5,H,Lo Wu,Departure,0,0,0,0
8/3/2020,Q3,5,H,Lok Ma Chau Spur Line,Arrival,0,0,0,0
8/3/2020,Q3,5,H,Lok Ma Chau Spur Line,Departure,0,0,0,0
8/3/2020,Q3,5,H,Hong Kong-Zhuhai-Macao Bridge,Arrival,28,4,11,43
8/3/2020,Q3,5,H,Hong Kong-Zhuhai-Macao Bridge,Departure,157,4,2,163
8/3/2020,Q3,5,H,Lok Ma Chau,Arrival,0,0,0,0
8/3/2020,Q3,5,H,Lok Ma Chau,Departure,0,0,0,0
8/3/2020,Q3,5,H,Man Kam To,Arrival,0,0,0,0
8/3/2020,Q3,5,H,Man Kam To,Departure,0,0,0,0
8/3/2020,Q3,5,H,Sha Tau Kok,Arrival,0,0,0,0
8/3/2020,Q3,5,H,Sha Tau Kok,Departure,0,0,0,0
8/3/2020,Q3,5,H,Shenzhen Bay,Arrival,428,22,9,459
8/3/2020,Q3,5,H,Shenzhen Bay,Departure,498,61,1,560
8/3/2020,Q3,5,H,China Ferry Terminal,Arrival,0,0,0,0
8/3/2020,Q3,5,H,China Ferry Terminal,Departure,0,0,0,0
8/3/2020,Q3,5,H,Harbour Control,Arrival,0,0,0,0
8/3/2020,Q3,5,H,Harbour Control,Departure,0,0,0,0
8/3/2020,Q3,5,H,Kai Tak Cruise Terminal,Arrival,0,0,0,0
8/3/2020,Q3,5,H,Kai Tak Cruise Terminal,Departure,0,0,0,0
8/3/2020,Q3,5,H,Macau Ferry Terminal,Arrival,0,0,0,0
8/3/2020,Q3,5,H,Macau Ferry Terminal,Departure,0,0,0,0
8/3/2020,Q3,5,H,Tuen Mun Ferry Terminal,Arrival,0,0,0,0
8/3/2020,Q3,5,H,Tuen Mun Ferry Terminal,Departure,0,0,0,0
8/4/2020,Q3,5,H,Airport,Arrival,693,3,34,730
8/4/2020,Q3,5,H,Airport,Departure,1440,61,91,1592
8/4/2020,Q3,5,H,Express Rail Link West Kowloon,Arrival,0,0,0,0
8/4/2020,Q3,5,H,Express Rail Link West Kowloon,Departure,0,0,0,0
8/4/2020,Q3,5,H,Hung Hom,Arrival,0,0,0,0
8/4/2020,Q3,5,H,Hung Hom,Departure,0,0,0,0
8/4/2020,Q3,5,H,Lo Wu,Arrival,0,0,0,0
8/4/2020,Q3,5,H,Lo Wu,Departure,0,0,0,0
8/4/2020,Q3,5,H,Lok Ma Chau Spur Line,Arrival,0,0,0,0
8/4/2020,Q3,5,H,Lok Ma Chau Spur Line,Departure,0,0,0,0
8/4/2020,Q3,5,H,Hong Kong-Zhuhai-Macao Bridge,Arrival,29,2,5,36
8/4/2020,Q3,5,H,Hong Kong-Zhuhai-Macao Bridge,Departure,188,21,7,216
8/4/2020,Q3,5,H,Lok Ma Chau,Arrival,0,0,0,0
8/4/2020,Q3,5,H,Lok Ma Chau,Departure,0,0,0,0
8/4/2020,Q3,5,H,Man Kam To,Arrival,0,0,0,0
8/4/2020,Q3,5,H,Man Kam To,Departure,0,0,0,0
8/4/2020,Q3,5,H,Sha Tau Kok,Arrival,0,0,0,0
8/4/2020,Q3,5,H,Sha Tau Kok,Departure,0,0,0,0
8/4/2020,Q3,5,H,Shenzhen Bay,Arrival,312,30,6,348
8/4/2020,Q3,5,H,Shenzhen Bay,Departure,939,103,6,1048
8/4/2020,Q3,5,H,China Ferry Terminal,Arrival,0,0,0,0
8/4/2020,Q3,5,H,China Ferry Terminal,Departure,0,0,0,0
8/4/2020,Q3,5,H,Harbour Control,Arrival,0,0,0,0
8/4/2020,Q3,5,H,Harbour Control,Departure,0,0,0,0
8/4/2020,Q3,5,H,Kai Tak Cruise Terminal,Arrival,0,0,0,0
8/4/2020,Q3,5,H,Kai Tak Cruise Terminal,Departure,0,0,0,0
8/4/2020,Q3,5,H,Macau Ferry Terminal,Arrival,0,0,0,0
8/4/2020,Q3,5,H,Macau Ferry Terminal,Departure,0,0,0,0
8/4/2020,Q3,5,H,Tuen Mun Ferry Terminal,Arrival,0,0,0,0
8/4/2020,Q3,5,H,Tuen Mun Ferry Terminal,Departure,0,0,0,0
8/5/2020,Q3,5,H,Airport,Arrival,683,3,40,726
8/5/2020,Q3,5,H,Airport,Departure,857,27,42,926
8/5/2020,Q3,5,H,Express Rail Link West Kowloon,Arrival,0,0,0,0
8/5/2020,Q3,5,H,Express Rail Link West Kowloon,Departure,0,0,0,0
8/5/2020,Q3,5,H,Hung Hom,Arrival,0,0,0,0
8/5/2020,Q3,5,H,Hung Hom,Departure,0,0,0,0
8/5/2020,Q3,5,H,Lo Wu,Arrival,0,0,0,0
8/5/2020,Q3,5,H,Lo Wu,Departure,0,0,0,0
8/5/2020,Q3,5,H,Lok Ma Chau Spur Line,Arrival,0,0,0,0
8/5/2020,Q3,5,H,Lok Ma Chau Spur Line,Departure,0,0,0,0
8/5/2020,Q3,5,H,Hong Kong-Zhuhai-Macao Bridge,Arrival,31,0,8,39
8/5/2020,Q3,5,H,Hong Kong-Zhuhai-Macao Bridge,Departure,255,14,10,279
8/5/2020,Q3,5,H,Lok Ma Chau,Arrival,0,0,0,0
8/5/2020,Q3,5,H,Lok Ma Chau,Departure,0,0,0,0
8/5/2020,Q3,5,H,Man Kam To,Arrival,0,0,0,0
8/5/2020,Q3,5,H,Man Kam To,Departure,0,0,0,0
8/5/2020,Q3,5,H,Sha Tau Kok,Arrival,0,0,0,0
8/5/2020,Q3,5,H,Sha Tau Kok,Departure,0,0,0,0
8/5/2020,Q3,5,H,Shenzhen Bay,Arrival,301,29,6,336
8/5/2020,Q3,5,H,Shenzhen Bay,Departure,1832,226,6,2064
8/5/2020,Q3,5,H,China Ferry Terminal,Arrival,0,0,0,0
8/5/2020,Q3,5,H,China Ferry Terminal,Departure,0,0,0,0
8/5/2020,Q3,5,H,Harbour Control,Arrival,0,0,0,0
8/5/2020,Q3,5,H,Harbour Control,Departure,0,0,0,0
8/5/2020,Q3,5,H,Kai Tak Cruise Terminal,Arrival,0,0,0,0
8/5/2020,Q3,5,H,Kai Tak Cruise Terminal,Departure,0,0,0,0
8/5/2020,Q3,5,H,Macau Ferry Terminal,Arrival,0,0,0,0
8/5/2020,Q3,5,H,Macau Ferry Terminal,Departure,0,0,0,0
8/5/2020,Q3,5,H,Tuen Mun Ferry Terminal,Arrival,0,0,0,0
8/5/2020,Q3,5,H,Tuen Mun Ferry Terminal,Departure,0,0,0,0
8/6/2020,Q3,5,H,Airport,Arrival,373,3,20,396
8/6/2020,Q3,5,H,Airport,Departure,1195,32,99,1326
8/6/2020,Q3,5,H,Express Rail Link West Kowloon,Arrival,0,0,0,0
8/6/2020,Q3,5,H,Express Rail Link West Kowloon,Departure,0,0,0,0
8/6/2020,Q3,5,H,Hung Hom,Arrival,0,0,0,0
8/6/2020,Q3,5,H,Hung Hom,Departure,0,0,0,0
8/6/2020,Q3,5,H,Lo Wu,Arrival,0,0,0,0
8/6/2020,Q3,5,H,Lo Wu,Departure,0,0,0,0
8/6/2020,Q3,5,H,Lok Ma Chau Spur Line,Arrival,0,0,0,0
8/6/2020,Q3,5,H,Lok Ma Chau Spur Line,Departure,0,0,0,0
8/6/2020,Q3,5,H,Hong Kong-Zhuhai-Macao Bridge,Arrival,41,2,5,48
8/6/2020,Q3,5,H,Hong Kong-Zhuhai-Macao Bridge,Departure,284,14,7,305
8/6/2020,Q3,5,H,Lok Ma Chau,Arrival,0,0,0,0
8/6/2020,Q3,5,H,Lok Ma Chau,Departure,0,0,0,0
8/6/2020,Q3,5,H,Man Kam To,Arrival,0,0,0,0
8/6/2020,Q3,5,H,Man Kam To,Departure,0,0,0,0
8/6/2020,Q3,5,H,Sha Tau Kok,Arrival,0,0,0,0
8/6/2020,Q3,5,H,Sha Tau Kok,Departure,0,0,0,0
8/6/2020,Q3,5,H,Shenzhen Bay,Arrival,347,37,2,386
8/6/2020,Q3,5,H,Shenzhen Bay,Departure,2262,302,5,2569
8/6/2020,Q3,5,H,China Ferry Terminal,Arrival,0,0,0,0
8/6/2020,Q3,5,H,China Ferry Terminal,Departure,0,0,0,0
8/6/2020,Q3,5,H,Harbour Control,Arrival,0,0,0,0
8/6/2020,Q3,5,H,Harbour Control,Departure,0,0,0,0
8/6/2020,Q3,5,H,Kai Tak Cruise Terminal,Arrival,0,0,0,0
8/6/2020,Q3,5,H,Kai Tak Cruise Terminal,Departure,0,0,0,0
8/6/2020,Q3,5,H,Macau Ferry Terminal,Arrival,0,0,0,0
8/6/2020,Q3,5,H,Macau Ferry Terminal,Departure,0,0,0,0
8/6/2020,Q3,5,H,Tuen Mun Ferry Terminal,Arrival,0,0,0,0
8/6/2020,Q3,5,H,Tuen Mun Ferry Terminal,Departure,0,0,0,0
8/7/2020,Q3,5,H,Airport,Arrival,672,5,46,723
8/7/2020,Q3,5,H,Airport,Departure,1312,32,117,1461
8/7/2020,Q3,5,H,Express Rail Link West Kowloon,Arrival,0,0,0,0
8/7/2020,Q3,5,H,Express Rail Link West Kowloon,Departure,0,0,0,0
8/7/2020,Q3,5,H,Hung Hom,Arrival,0,0,0,0
8/7/2020,Q3,5,H,Hung Hom,Departure,0,0,0,0
8/7/2020,Q3,5,H,Lo Wu,Arrival,0,0,0,0
8/7/2020,Q3,5,H,Lo Wu,Departure,0,0,0,0
8/7/2020,Q3,5,H,Lok Ma Chau Spur Line,Arrival,0,0,0,0
8/7/2020,Q3,5,H,Lok Ma Chau Spur Line,Departure,0,0,0,0
8/7/2020,Q3,5,H,Hong Kong-Zhuhai-Macao Bridge,Arrival,26,1,10,37
8/7/2020,Q3,5,H,Hong Kong-Zhuhai-Macao Bridge,Departure,149,12,8,169
8/7/2020,Q3,5,H,Lok Ma Chau,Arrival,0,0,0,0
8/7/2020,Q3,5,H,Lok Ma Chau,Departure,0,0,0,0
8/7/2020,Q3,5,H,Man Kam To,Arrival,0,0,0,0
8/7/2020,Q3,5,H,Man Kam To,Departure,0,0,0,0
8/7/2020,Q3,5,H,Sha Tau Kok,Arrival,0,0,0,0
8/7/2020,Q3,5,H,Sha Tau Kok,Departure,0,0,0,0
8/7/2020,Q3,5,H,Shenzhen Bay,Arrival,411,32,6,449
8/7/2020,Q3,5,H,Shenzhen Bay,Departure,931,108,2,1041
8/7/2020,Q3,5,H,China Ferry Terminal,Arrival,0,0,0,0
8/7/2020,Q3,5,H,China Ferry Terminal,Departure,0,0,0,0
8/7/2020,Q3,5,H,Harbour Control,Arrival,0,0,0,0
8/7/2020,Q3,5,H,Harbour Control,Departure,0,0,0,0
8/7/2020,Q3,5,H,Kai Tak Cruise Terminal,Arrival,0,0,0,0
8/7/2020,Q3,5,H,Kai Tak Cruise Terminal,Departure,0,0,0,0
8/7/2020,Q3,5,H,Macau Ferry Terminal,Arrival,0,0,0,0
8/7/2020,Q3,5,H,Macau Ferry Terminal,Departure,0,0,0,0
8/7/2020,Q3,5,H,Tuen Mun Ferry Terminal,Arrival,0,0,0,0
8/7/2020,Q3,5,H,Tuen Mun Ferry Terminal,Departure,0,0,0,0
8/8/2020,Q3,5,H,Airport,Arrival,646,5,22,673
8/8/2020,Q3,5,H,Airport,Departure,1594,65,56,1715
8/8/2020,Q3,5,H,Express Rail Link West Kowloon,Arrival,0,0,0,0
8/8/2020,Q3,5,H,Express Rail Link West Kowloon,Departure,0,0,0,0
8/8/2020,Q3,5,H,Hung Hom,Arrival,0,0,0,0
8/8/2020,Q3,5,H,Hung Hom,Departure,0,0,0,0
8/8/2020,Q3,5,H,Lo Wu,Arrival,0,0,0,0
8/8/2020,Q3,5,H,Lo Wu,Departure,0,0,0,0
8/8/2020,Q3,5,H,Lok Ma Chau Spur Line,Arrival,0,0,0,0
8/8/2020,Q3,5,H,Lok Ma Chau Spur Line,Departure,0,0,0,0
8/8/2020,Q3,5,H,Hong Kong-Zhuhai-Macao Bridge,Arrival,38,3,5,46
8/8/2020,Q3,5,H,Hong Kong-Zhuhai-Macao Bridge,Departure,181,15,4,200
8/8/2020,Q3,5,H,Lok Ma Chau,Arrival,0,0,0,0
8/8/2020,Q3,5,H,Lok Ma Chau,Departure,0,0,0,0
8/8/2020,Q3,5,H,Man Kam To,Arrival,0,0,0,0
8/8/2020,Q3,5,H,Man Kam To,Departure,0,0,0,0
8/8/2020,Q3,5,H,Sha Tau Kok,Arrival,0,0,0,0
8/8/2020,Q3,5,H,Sha Tau Kok,Departure,0,0,0,0
8/8/2020,Q3,5,H,Shenzhen Bay,Arrival,370,51,7,428
8/8/2020,Q3,5,H,Shenzhen Bay,Departure,852,105,1,958
8/8/2020,Q3,5,H,China Ferry Terminal,Arrival,0,0,0,0
8/8/2020,Q3,5,H,China Ferry Terminal,Departure,0,0,0,0
8/8/2020,Q3,5,H,Harbour Control,Arrival,0,0,0,0
8/8/2020,Q3,5,H,Harbour Control,Departure,0,0,0,0
8/8/2020,Q3,5,H,Kai Tak Cruise Terminal,Arrival,0,0,0,0
8/8/2020,Q3,5,H,Kai Tak Cruise Terminal,Departure,0,0,0,0
8/8/2020,Q3,5,H,Macau Ferry Terminal,Arrival,0,0,0,0
8/8/2020,Q3,5,H,Macau Ferry Terminal,Departure,0,0,0,0
8/8/2020,Q3,5,H,Tuen Mun Ferry Terminal,Arrival,0,0,0,0
8/8/2020,Q3,5,H,Tuen Mun Ferry Terminal,Departure,0,0,0,0
8/9/2020,Q3,5,H,Airport,Arrival,621,10,28,659
8/9/2020,Q3,5,H,Airport,Departure,1522,47,84,1653
8/9/2020,Q3,5,H,Express Rail Link West Kowloon,Arrival,0,0,0,0
8/9/2020,Q3,5,H,Express Rail Link West Kowloon,Departure,0,0,0,0
8/9/2020,Q3,5,H,Hung Hom,Arrival,0,0,0,0
8/9/2020,Q3,5,H,Hung Hom,Departure,0,0,0,0
8/9/2020,Q3,5,H,Lo Wu,Arrival,0,0,0,0
8/9/2020,Q3,5,H,Lo Wu,Departure,0,0,0,0
8/9/2020,Q3,5,H,Lok Ma Chau Spur Line,Arrival,0,0,0,0
8/9/2020,Q3,5,H,Lok Ma Chau Spur Line,Departure,0,0,0,0
8/9/2020,Q3,5,H,Hong Kong-Zhuhai-Macao Bridge,Arrival,42,4,6,52
8/9/2020,Q3,5,H,Hong Kong-Zhuhai-Macao Bridge,Departure,113,6,3,122
8/9/2020,Q3,5,H,Lok Ma Chau,Arrival,0,0,0,0
8/9/2020,Q3,5,H,Lok Ma Chau,Departure,0,0,0,0
8/9/2020,Q3,5,H,Man Kam To,Arrival,0,0,0,0
8/9/2020,Q3,5,H,Man Kam To,Departure,0,0,0,0
8/9/2020,Q3,5,H,Sha Tau Kok,Arrival,0,0,0,0
8/9/2020,Q3,5,H,Sha Tau Kok,Departure,0,0,0,0
8/9/2020,Q3,5,H,Shenzhen Bay,Arrival,415,37,1,453
8/9/2020,Q3,5,H,Shenzhen Bay,Departure,646,78,2,726
8/9/2020,Q3,5,H,China Ferry Terminal,Arrival,0,0,0,0
8/9/2020,Q3,5,H,China Ferry Terminal,Departure,0,0,0,0
8/9/2020,Q3,5,H,Harbour Control,Arrival,0,0,0,0
8/9/2020,Q3,5,H,Harbour Control,Departure,0,0,0,0
8/9/2020,Q3,5,H,Kai Tak Cruise Terminal,Arrival,0,0,0,0
8/9/2020,Q3,5,H,Kai Tak Cruise Terminal,Departure,0,0,0,0
8/9/2020,Q3,5,H,Macau Ferry Terminal,Arrival,0,0,0,0
8/9/2020,Q3,5,H,Macau Ferry Terminal,Departure,0,0,0,0
8/9/2020,Q3,5,H,Tuen Mun Ferry Terminal,Arrival,0,0,0,0
8/9/2020,Q3,5,H,Tuen Mun Ferry Terminal,Departure,0,0,0,0
8/10/2020,Q3,5,H,Airport,Arrival,528,10,22,560
8/10/2020,Q3,5,H,Airport,Departure,749,19,78,846
8/10/2020,Q3,5,H,Express Rail Link West Kowloon,Arrival,0,0,0,0
8/10/2020,Q3,5,H,Express Rail Link West Kowloon,Departure,0,0,0,0
8/10/2020,Q3,5,H,Hung Hom,Arrival,0,0,0,0
8/10/2020,Q3,5,H,Hung Hom,Departure,0,0,0,0
8/10/2020,Q3,5,H,Lo Wu,Arrival,0,0,0,0
8/10/2020,Q3,5,H,Lo Wu,Departure,0,0,0,0
8/10/2020,Q3,5,H,Lok Ma Chau Spur Line,Arrival,0,0,0,0
8/10/2020,Q3,5,H,Lok Ma Chau Spur Line,Departure,0,0,0,0
8/10/2020,Q3,5,H,Hong Kong-Zhuhai-Macao Bridge,Arrival,33,3,7,43
8/10/2020,Q3,5,H,Hong Kong-Zhuhai-Macao Bridge,Departure,98,3,4,105
8/10/2020,Q3,5,H,Lok Ma Chau,Arrival,0,0,0,0
8/10/2020,Q3,5,H,Lok Ma Chau,Departure,0,0,0,0
8/10/2020,Q3,5,H,Man Kam To,Arrival,0,0,0,0
8/10/2020,Q3,5,H,Man Kam To,Departure,0,0,0,0
8/10/2020,Q3,5,H,Sha Tau Kok,Arrival,0,0,0,0
8/10/2020,Q3,5,H,Sha Tau Kok,Departure,0,0,0,0
8/10/2020,Q3,5,H,Shenzhen Bay,Arrival,530,43,2,575
8/10/2020,Q3,5,H,Shenzhen Bay,Departure,500,49,1,550
8/10/2020,Q3,5,H,China Ferry Terminal,Arrival,0,0,0,0
8/10/2020,Q3,5,H,China Ferry Terminal,Departure,0,0,0,0
8/10/2020,Q3,5,H,Harbour Control,Arrival,0,0,0,0
8/10/2020,Q3,5,H,Harbour Control,Departure,0,0,0,0
8/10/2020,Q3,5,H,Kai Tak Cruise Terminal,Arrival,0,0,0,0
8/10/2020,Q3,5,H,Kai Tak Cruise Terminal,Departure,0,0,0,0
8/10/2020,Q3,5,H,Macau Ferry Terminal,Arrival,0,0,0,0
8/10/2020,Q3,5,H,Macau Ferry Terminal,Departure,0,0,0,0
8/10/2020,Q3,5,H,Tuen Mun Ferry Terminal,Arrival,0,0,0,0
8/10/2020,Q3,5,H,Tuen Mun Ferry Terminal,Departure,0,0,0,0
8/11/2020,Q3,5,H,Airport,Arrival,798,2,33,833
8/11/2020,Q3,5,H,Airport,Departure,988,23,57,1068
8/11/2020,Q3,5,H,Express Rail Link West Kowloon,Arrival,0,0,0,0
8/11/2020,Q3,5,H,Express Rail Link West Kowloon,Departure,0,0,0,0
8/11/2020,Q3,5,H,Hung Hom,Arrival,0,0,0,0
8/11/2020,Q3,5,H,Hung Hom,Departure,0,0,0,0
8/11/2020,Q3,5,H,Lo Wu,Arrival,0,0,0,0
8/11/2020,Q3,5,H,Lo Wu,Departure,0,0,0,0
8/11/2020,Q3,5,H,Lok Ma Chau Spur Line,Arrival,0,0,0,0
8/11/2020,Q3,5,H,Lok Ma Chau Spur Line,Departure,0,0,0,0
8/11/2020,Q3,5,H,Hong Kong-Zhuhai-Macao Bridge,Arrival,23,1,2,26
8/11/2020,Q3,5,H,Hong Kong-Zhuhai-Macao Bridge,Departure,167,4,3,174
8/11/2020,Q3,5,H,Lok Ma Chau,Arrival,0,0,0,0
8/11/2020,Q3,5,H,Lok Ma Chau,Departure,0,0,0,0
8/11/2020,Q3,5,H,Man Kam To,Arrival,0,0,0,0
8/11/2020,Q3,5,H,Man Kam To,Departure,0,0,0,0
8/11/2020,Q3,5,H,Sha Tau Kok,Arrival,0,0,0,0
8/11/2020,Q3,5,H,Sha Tau Kok,Departure,0,0,0,0
8/11/2020,Q3,5,H,Shenzhen Bay,Arrival,383,44,3,430
8/11/2020,Q3,5,H,Shenzhen Bay,Departure,884,111,4,999
8/11/2020,Q3,5,H,China Ferry Terminal,Arrival,0,0,0,0
8/11/2020,Q3,5,H,China Ferry Terminal,Departure,0,0,0,0
8/11/2020,Q3,5,H,Harbour Control,Arrival,0,0,0,0
8/11/2020,Q3,5,H,Harbour Control,Departure,0,0,0,0
8/11/2020,Q3,5,H,Kai Tak Cruise Terminal,Arrival,0,0,0,0
8/11/2020,Q3,5,H,Kai Tak Cruise Terminal,Departure,0,0,0,0
8/11/2020,Q3,5,H,Macau Ferry Terminal,Arrival,0,0,0,0
8/11/2020,Q3,5,H,Macau Ferry Terminal,Departure,0,0,0,0
8/11/2020,Q3,5,H,Tuen Mun Ferry Terminal,Arrival,0,0,0,0
8/11/2020,Q3,5,H,Tuen Mun Ferry Terminal,Departure,0,0,0,0
8/12/2020,Q3,5,H,Airport,Arrival,388,7,21,416
8/12/2020,Q3,5,H,Airport,Departure,922,24,43,989
8/12/2020,Q3,5,H,Express Rail Link West Kowloon,Arrival,0,0,0,0
8/12/2020,Q3,5,H,Express Rail Link West Kowloon,Departure,0,0,0,0
8/12/2020,Q3,5,H,Hung Hom,Arrival,0,0,0,0
8/12/2020,Q3,5,H,Hung Hom,Departure,0,0,0,0
8/12/2020,Q3,5,H,Lo Wu,Arrival,0,0,0,0
8/12/2020,Q3,5,H,Lo Wu,Departure,0,0,0,0
8/12/2020,Q3,5,H,Lok Ma Chau Spur Line,Arrival,0,0,0,0
8/12/2020,Q3,5,H,Lok Ma Chau Spur Line,Departure,0,0,0,0
8/12/2020,Q3,5,H,Hong Kong-Zhuhai-Macao Bridge,Arrival,40,0,5,45
8/12/2020,Q3,5,H,Hong Kong-Zhuhai-Macao Bridge,Departure,203,23,3,229
8/12/2020,Q3,5,H,Lok Ma Chau,Arrival,0,0,0,0
8/12/2020,Q3,5,H,Lok Ma Chau,Departure,0,0,0,0
8/12/2020,Q3,5,H,Man Kam To,Arrival,0,0,0,0
8/12/2020,Q3,5,H,Man Kam To,Departure,0,0,0,0
8/12/2020,Q3,5,H,Sha Tau Kok,Arrival,0,0,0,0
8/12/2020,Q3,5,H,Sha Tau Kok,Departure,0,0,0,0
8/12/2020,Q3,5,H,Shenzhen Bay,Arrival,504,51,8,563
8/12/2020,Q3,5,H,Shenzhen Bay,Departure,1062,169,4,1235
8/12/2020,Q3,5,H,China Ferry Terminal,Arrival,0,0,0,0
8/12/2020,Q3,5,H,China Ferry Terminal,Departure,0,0,0,0
8/12/2020,Q3,5,H,Harbour Control,Arrival,0,0,0,0
8/12/2020,Q3,5,H,Harbour Control,Departure,0,0,0,0
8/12/2020,Q3,5,H,Kai Tak Cruise Terminal,Arrival,0,0,0,0
8/12/2020,Q3,5,H,Kai Tak Cruise Terminal,Departure,0,0,0,0
8/12/2020,Q3,5,H,Macau Ferry Terminal,Arrival,0,0,0,0
8/12/2020,Q3,5,H,Macau Ferry Terminal,Departure,0,0,0,0
8/12/2020,Q3,5,H,Tuen Mun Ferry Terminal,Arrival,0,0,0,0
8/12/2020,Q3,5,H,Tuen Mun Ferry Terminal,Departure,0,0,0,0
8/13/2020,Q3,5,H,Airport,Arrival,532,2,16,550
8/13/2020,Q3,5,H,Airport,Departure,1179,15,61,1255
8/13/2020,Q3,5,H,Express Rail Link West Kowloon,Arrival,0,0,0,0
8/13/2020,Q3,5,H,Express Rail Link West Kowloon,Departure,0,0,0,0
8/13/2020,Q3,5,H,Hung Hom,Arrival,0,0,0,0
8/13/2020,Q3,5,H,Hung Hom,Departure,0,0,0,0
8/13/2020,Q3,5,H,Lo Wu,Arrival,0,0,0,0
8/13/2020,Q3,5,H,Lo Wu,Departure,0,0,0,0
8/13/2020,Q3,5,H,Lok Ma Chau Spur Line,Arrival,0,0,0,0
8/13/2020,Q3,5,H,Lok Ma Chau Spur Line,Departure,0,0,0,0
8/13/2020,Q3,5,H,Hong Kong-Zhuhai-Macao Bridge,Arrival,38,3,6,47
8/13/2020,Q3,5,H,Hong Kong-Zhuhai-Macao Bridge,Departure,194,10,5,209
8/13/2020,Q3,5,H,Lok Ma Chau,Arrival,0,0,0,0
8/13/2020,Q3,5,H,Lok Ma Chau,Departure,0,0,0,0
8/13/2020,Q3,5,H,Man Kam To,Arrival,0,0,0,0
8/13/2020,Q3,5,H,Man Kam To,Departure,0,0,0,0
8/13/2020,Q3,5,H,Sha Tau Kok,Arrival,0,0,0,0
8/13/2020,Q3,5,H,Sha Tau Kok,Departure,0,0,0,0
8/13/2020,Q3,5,H,Shenzhen Bay,Arrival,571,53,3,627
8/13/2020,Q3,5,H,Shenzhen Bay,Departure,1035,156,4,1195
8/13/2020,Q3,5,H,China Ferry Terminal,Arrival,0,0,0,0
8/13/2020,Q3,5,H,China Ferry Terminal,Departure,0,0,0,0
8/13/2020,Q3,5,H,Harbour Control,Arrival,0,0,0,0
8/13/2020,Q3,5,H,Harbour Control,Departure,0,0,0,0
8/13/2020,Q3,5,H,Kai Tak Cruise Terminal,Arrival,0,0,0,0
8/13/2020,Q3,5,H,Kai Tak Cruise Terminal,Departure,0,0,0,0
8/13/2020,Q3,5,H,Macau Ferry Terminal,Arrival,0,0,0,0
8/13/2020,Q3,5,H,Macau Ferry Terminal,Departure,0,0,0,0
8/13/2020,Q3,5,H,Tuen Mun Ferry Terminal,Arrival,0,0,0,0
8/13/2020,Q3,5,H,Tuen Mun Ferry Terminal,Departure,0,0,0,0
8/14/2020,Q3,5,H,Airport,Arrival,793,3,49,845
8/14/2020,Q3,5,H,Airport,Departure,1565,23,88,1676
8/14/2020,Q3,5,H,Express Rail Link West Kowloon,Arrival,0,0,0,0
8/14/2020,Q3,5,H,Express Rail Link West Kowloon,Departure,0,0,0,0
8/14/2020,Q3,5,H,Hung Hom,Arrival,0,0,0,0
8/14/2020,Q3,5,H,Hung Hom,Departure,0,0,0,0
8/14/2020,Q3,5,H,Lo Wu,Arrival,0,0,0,0
8/14/2020,Q3,5,H,Lo Wu,Departure,0,0,0,0
8/14/2020,Q3,5,H,Lok Ma Chau Spur Line,Arrival,0,0,0,0
8/14/2020,Q3,5,H,Lok Ma Chau Spur Line,Departure,0,0,0,0
8/14/2020,Q3,5,H,Hong Kong-Zhuhai-Macao Bridge,Arrival,51,1,7,59
8/14/2020,Q3,5,H,Hong Kong-Zhuhai-Macao Bridge,Departure,188,7,7,202
8/14/2020,Q3,5,H,Lok Ma Chau,Arrival,0,0,0,0
8/14/2020,Q3,5,H,Lok Ma Chau,Departure,0,0,0,0
8/14/2020,Q3,5,H,Man Kam To,Arrival,0,0,0,0
8/14/2020,Q3,5,H,Man Kam To,Departure,0,0,0,0
8/14/2020,Q3,5,H,Sha Tau Kok,Arrival,0,0,0,0
8/14/2020,Q3,5,H,Sha Tau Kok,Departure,0,0,0,0
8/14/2020,Q3,5,H,Shenzhen Bay,Arrival,500,48,2,550
8/14/2020,Q3,5,H,Shenzhen Bay,Departure,880,85,5,970
8/14/2020,Q3,5,H,China Ferry Terminal,Arrival,0,0,0,0
8/14/2020,Q3,5,H,China Ferry Terminal,Departure,0,0,0,0
8/14/2020,Q3,5,H,Harbour Control,Arrival,0,0,0,0
8/14/2020,Q3,5,H,Harbour Control,Departure,0,0,0,0
8/14/2020,Q3,5,H,Kai Tak Cruise Terminal,Arrival,0,0,0,0
8/14/2020,Q3,5,H,Kai Tak Cruise Terminal,Departure,0,0,0,0
8/14/2020,Q3,5,H,Macau Ferry Terminal,Arrival,0,0,0,0
8/14/2020,Q3,5,H,Macau Ferry Terminal,Departure,0,0,0,0
8/14/2020,Q3,5,H,Tuen Mun Ferry Terminal,Arrival,0,0,0,0
8/14/2020,Q3,5,H,Tuen Mun Ferry Terminal,Departure,0,0,0,0
8/15/2020,Q3,5,H,Airport,Arrival,745,5,39,789
8/15/2020,Q3,5,H,Airport,Departure,1636,44,195,1875
8/15/2020,Q3,5,H,Express Rail Link West Kowloon,Arrival,0,0,0,0
8/15/2020,Q3,5,H,Express Rail Link West Kowloon,Departure,0,0,0,0
8/15/2020,Q3,5,H,Hung Hom,Arrival,0,0,0,0
8/15/2020,Q3,5,H,Hung Hom,Departure,0,0,0,0
8/15/2020,Q3,5,H,Lo Wu,Arrival,0,0,0,0
8/15/2020,Q3,5,H,Lo Wu,Departure,0,0,0,0
8/15/2020,Q3,5,H,Lok Ma Chau Spur Line,Arrival,0,0,0,0
8/15/2020,Q3,5,H,Lok Ma Chau Spur Line,Departure,0,0,0,0
8/15/2020,Q3,5,H,Hong Kong-Zhuhai-Macao Bridge,Arrival,46,9,33,88
8/15/2020,Q3,5,H,Hong Kong-Zhuhai-Macao Bridge,Departure,152,6,4,162
8/15/2020,Q3,5,H,Lok Ma Chau,Arrival,0,0,0,0
8/15/2020,Q3,5,H,Lok Ma Chau,Departure,0,0,0,0
8/15/2020,Q3,5,H,Man Kam To,Arrival,0,0,0,0
8/15/2020,Q3,5,H,Man Kam To,Departure,0,0,0,0
8/15/2020,Q3,5,H,Sha Tau Kok,Arrival,0,0,0,0
8/15/2020,Q3,5,H,Sha Tau Kok,Departure,0,0,0,0
8/15/2020,Q3,5,H,Shenzhen Bay,Arrival,629,76,6,711
8/15/2020,Q3,5,H,Shenzhen Bay,Departure,774,108,7,889
8/15/2020,Q3,5,H,China Ferry Terminal,Arrival,0,0,0,0
8/15/2020,Q3,5,H,China Ferry Terminal,Departure,0,0,0,0
8/15/2020,Q3,5,H,Harbour Control,Arrival,0,0,0,0
8/15/2020,Q3,5,H,Harbour Control,Departure,0,0,0,0
8/15/2020,Q3,5,H,Kai Tak Cruise Terminal,Arrival,0,0,0,0
8/15/2020,Q3,5,H,Kai Tak Cruise Terminal,Departure,0,0,0,0
8/15/2020,Q3,5,H,Macau Ferry Terminal,Arrival,0,0,0,0
8/15/2020,Q3,5,H,Macau Ferry Terminal,Departure,0,0,0,0
8/15/2020,Q3,5,H,Tuen Mun Ferry Terminal,Arrival,0,0,0,0
8/15/2020,Q3,5,H,Tuen Mun Ferry Terminal,Departure,0,0,0,0
8/16/2020,Q3,5,H,Airport,Arrival,786,11,21,818
8/16/2020,Q3,5,H,Airport,Departure,1595,35,74,1704
8/16/2020,Q3,5,H,Express Rail Link West Kowloon,Arrival,0,0,0,0
8/16/2020,Q3,5,H,Express Rail Link West Kowloon,Departure,0,0,0,0
8/16/2020,Q3,5,H,Hung Hom,Arrival,0,0,0,0
8/16/2020,Q3,5,H,Hung Hom,Departure,0,0,0,0
8/16/2020,Q3,5,H,Lo Wu,Arrival,0,0,0,0
8/16/2020,Q3,5,H,Lo Wu,Departure,0,0,0,0
8/16/2020,Q3,5,H,Lok Ma Chau Spur Line,Arrival,0,0,0,0
8/16/2020,Q3,5,H,Lok Ma Chau Spur Line,Departure,0,0,0,0
8/16/2020,Q3,5,H,Hong Kong-Zhuhai-Macao Bridge,Arrival,51,3,1,55
8/16/2020,Q3,5,H,Hong Kong-Zhuhai-Macao Bridge,Departure,113,7,6,126
8/16/2020,Q3,5,H,Lok Ma Chau,Arrival,0,0,0,0
8/16/2020,Q3,5,H,Lok Ma Chau,Departure,0,0,0,0
8/16/2020,Q3,5,H,Man Kam To,Arrival,0,0,0,0
8/16/2020,Q3,5,H,Man Kam To,Departure,0,0,0,0
8/16/2020,Q3,5,H,Sha Tau Kok,Arrival,0,0,0,0
8/16/2020,Q3,5,H,Sha Tau Kok,Departure,0,0,0,0
8/16/2020,Q3,5,H,Shenzhen Bay,Arrival,699,57,6,762
8/16/2020,Q3,5,H,Shenzhen Bay,Departure,659,69,2,730
8/16/2020,Q3,5,H,China Ferry Terminal,Arrival,0,0,0,0
8/16/2020,Q3,5,H,China Ferry Terminal,Departure,0,0,0,0
8/16/2020,Q3,5,H,Harbour Control,Arrival,0,0,0,0
8/16/2020,Q3,5,H,Harbour Control,Departure,0,0,0,0
8/16/2020,Q3,5,H,Kai Tak Cruise Terminal,Arrival,0,0,0,0
8/16/2020,Q3,5,H,Kai Tak Cruise Terminal,Departure,0,0,0,0
8/16/2020,Q3,5,H,Macau Ferry Terminal,Arrival,0,0,0,0
8/16/2020,Q3,5,H,Macau Ferry Terminal,Departure,0,0,0,0
8/16/2020,Q3,5,H,Tuen Mun Ferry Terminal,Arrival,0,0,0,0
8/16/2020,Q3,5,H,Tuen Mun Ferry Terminal,Departure,0,0,0,0
8/17/2020,Q3,5,H,Airport,Arrival,690,6,22,718
8/17/2020,Q3,5,H,Airport,Departure,913,15,32,960
8/17/2020,Q3,5,H,Express Rail Link West Kowloon,Arrival,0,0,0,0
8/17/2020,Q3,5,H,Express Rail Link West Kowloon,Departure,0,0,0,0
8/17/2020,Q3,5,H,Hung Hom,Arrival,0,0,0,0
8/17/2020,Q3,5,H,Hung Hom,Departure,0,0,0,0
8/17/2020,Q3,5,H,Lo Wu,Arrival,0,0,0,0
8/17/2020,Q3,5,H,Lo Wu,Departure,0,0,0,0
8/17/2020,Q3,5,H,Lok Ma Chau Spur Line,Arrival,0,0,0,0
8/17/2020,Q3,5,H,Lok Ma Chau Spur Line,Departure,0,0,0,0
8/17/2020,Q3,5,H,Hong Kong-Zhuhai-Macao Bridge,Arrival,48,0,7,55
8/17/2020,Q3,5,H,Hong Kong-Zhuhai-Macao Bridge,Departure,96,5,3,104
8/17/2020,Q3,5,H,Lok Ma Chau,Arrival,0,0,0,0
8/17/2020,Q3,5,H,Lok Ma Chau,Departure,0,0,0,0
8/17/2020,Q3,5,H,Man Kam To,Arrival,0,0,0,0
8/17/2020,Q3,5,H,Man Kam To,Departure,0,0,0,0
8/17/2020,Q3,5,H,Sha Tau Kok,Arrival,0,0,0,0
8/17/2020,Q3,5,H,Sha Tau Kok,Departure,0,0,0,0
8/17/2020,Q3,5,H,Shenzhen Bay,Arrival,710,71,1,782
8/17/2020,Q3,5,H,Shenzhen Bay,Departure,443,46,1,490
8/17/2020,Q3,5,H,China Ferry Terminal,Arrival,0,0,0,0
8/17/2020,Q3,5,H,China Ferry Terminal,Departure,0,0,0,0
8/17/2020,Q3,5,H,Harbour Control,Arrival,0,0,0,0
8/17/2020,Q3,5,H,Harbour Control,Departure,0,0,0,0
8/17/2020,Q3,5,H,Kai Tak Cruise Terminal,Arrival,0,0,0,0
8/17/2020,Q3,5,H,Kai Tak Cruise Terminal,Departure,0,0,0,0
8/17/2020,Q3,5,H,Macau Ferry Terminal,Arrival,0,0,0,0
8/17/2020,Q3,5,H,Macau Ferry Terminal,Departure,0,0,0,0
8/17/2020,Q3,5,H,Tuen Mun Ferry Terminal,Arrival,0,0,0,0
8/17/2020,Q3,5,H,Tuen Mun Ferry Terminal,Departure,0,0,0,0
8/18/2020,Q3,5,H,Airport,Arrival,435,0,14,449
8/18/2020,Q3,5,H,Airport,Departure,1253,19,48,1320
8/18/2020,Q3,5,H,Express Rail Link West Kowloon,Arrival,0,0,0,0
8/18/2020,Q3,5,H,Express Rail Link West Kowloon,Departure,0,0,0,0
8/18/2020,Q3,5,H,Hung Hom,Arrival,0,0,0,0
8/18/2020,Q3,5,H,Hung Hom,Departure,0,0,0,0
8/18/2020,Q3,5,H,Lo Wu,Arrival,0,0,0,0
8/18/2020,Q3,5,H,Lo Wu,Departure,0,0,0,0
8/18/2020,Q3,5,H,Lok Ma Chau Spur Line,Arrival,0,0,0,0
8/18/2020,Q3,5,H,Lok Ma Chau Spur Line,Departure,0,0,0,0
8/18/2020,Q3,5,H,Hong Kong-Zhuhai-Macao Bridge,Arrival,57,1,7,65
8/18/2020,Q3,5,H,Hong Kong-Zhuhai-Macao Bridge,Departure,150,10,8,168
8/18/2020,Q3,5,H,Lok Ma Chau,Arrival,0,0,0,0
8/18/2020,Q3,5,H,Lok Ma Chau,Departure,0,0,0,0
8/18/2020,Q3,5,H,Man Kam To,Arrival,0,0,0,0
8/18/2020,Q3,5,H,Man Kam To,Departure,0,0,0,0
8/18/2020,Q3,5,H,Sha Tau Kok,Arrival,0,0,0,0
8/18/2020,Q3,5,H,Sha Tau Kok,Departure,0,0,0,0
8/18/2020,Q3,5,H,Shenzhen Bay,Arrival,673,49,2,724
8/18/2020,Q3,5,H,Shenzhen Bay,Departure,782,78,3,863
8/18/2020,Q3,5,H,China Ferry Terminal,Arrival,0,0,0,0
8/18/2020,Q3,5,H,China Ferry Terminal,Departure,0,0,0,0
8/18/2020,Q3,5,H,Harbour Control,Arrival,0,0,0,0
8/18/2020,Q3,5,H,Harbour Control,Departure,0,0,0,0
8/18/2020,Q3,5,H,Kai Tak Cruise Terminal,Arrival,0,0,0,0
8/18/2020,Q3,5,H,Kai Tak Cruise Terminal,Departure,0,0,0,0
8/18/2020,Q3,5,H,Macau Ferry Terminal,Arrival,0,0,0,0
8/18/2020,Q3,5,H,Macau Ferry Terminal,Departure,0,0,0,0
8/18/2020,Q3,5,H,Tuen Mun Ferry Terminal,Arrival,0,0,0,0
8/18/2020,Q3,5,H,Tuen Mun Ferry Terminal,Departure,0,0,0,0
8/19/2020,Q3,5,H,Airport,Arrival,501,1,21,523
8/19/2020,Q3,5,H,Airport,Departure,870,10,33,913
8/19/2020,Q3,5,H,Express Rail Link West Kowloon,Arrival,0,0,0,0
8/19/2020,Q3,5,H,Express Rail Link West Kowloon,Departure,0,0,0,0
8/19/2020,Q3,5,H,Hung Hom,Arrival,0,0,0,0
8/19/2020,Q3,5,H,Hung Hom,Departure,0,0,0,0
8/19/2020,Q3,5,H,Lo Wu,Arrival,0,0,0,0
8/19/2020,Q3,5,H,Lo Wu,Departure,0,0,0,0
8/19/2020,Q3,5,H,Lok Ma Chau Spur Line,Arrival,0,0,0,0
8/19/2020,Q3,5,H,Lok Ma Chau Spur Line,Departure,0,0,0,0
8/19/2020,Q3,5,H,Hong Kong-Zhuhai-Macao Bridge,Arrival,17,0,2,19
8/19/2020,Q3,5,H,Hong Kong-Zhuhai-Macao Bridge,Departure,79,3,1,83
8/19/2020,Q3,5,H,Lok Ma Chau,Arrival,0,0,0,0
8/19/2020,Q3,5,H,Lok Ma Chau,Departure,0,0,0,0
8/19/2020,Q3,5,H,Man Kam To,Arrival,0,0,0,0
8/19/2020,Q3,5,H,Man Kam To,Departure,0,0,0,0
8/19/2020,Q3,5,H,Sha Tau Kok,Arrival,0,0,0,0
8/19/2020,Q3,5,H,Sha Tau Kok,Departure,0,0,0,0
8/19/2020,Q3,5,H,Shenzhen Bay,Arrival,359,27,5,391
8/19/2020,Q3,5,H,Shenzhen Bay,Departure,806,111,1,918
8/19/2020,Q3,5,H,China Ferry Terminal,Arrival,0,0,0,0
8/19/2020,Q3,5,H,China Ferry Terminal,Departure,0,0,0,0
8/19/2020,Q3,5,H,Harbour Control,Arrival,0,0,0,0
8/19/2020,Q3,5,H,Harbour Control,Departure,0,0,0,0
8/19/2020,Q3,5,H,Kai Tak Cruise Terminal,Arrival,0,0,0,0
8/19/2020,Q3,5,H,Kai Tak Cruise Terminal,Departure,0,0,0,0
8/19/2020,Q3,5,H,Macau Ferry Terminal,Arrival,0,0,0,0
8/19/2020,Q3,5,H,Macau Ferry Terminal,Departure,0,0,0,0
8/19/2020,Q3,5,H,Tuen Mun Ferry Terminal,Arrival,0,0,0,0
8/19/2020,Q3,5,H,Tuen Mun Ferry Terminal,Departure,0,0,0,0
8/20/2020,Q3,5,H,Airport,Arrival,712,1,29,742
8/20/2020,Q3,5,H,Airport,Departure,1260,6,54,1320
8/20/2020,Q3,5,H,Express Rail Link West Kowloon,Arrival,0,0,0,0
8/20/2020,Q3,5,H,Express Rail Link West Kowloon,Departure,0,0,0,0
8/20/2020,Q3,5,H,Hung Hom,Arrival,0,0,0,0
8/20/2020,Q3,5,H,Hung Hom,Departure,0,0,0,0
8/20/2020,Q3,5,H,Lo Wu,Arrival,0,0,0,0
8/20/2020,Q3,5,H,Lo Wu,Departure,0,0,0,0
8/20/2020,Q3,5,H,Lok Ma Chau Spur Line,Arrival,0,0,0,0
8/20/2020,Q3,5,H,Lok Ma Chau Spur Line,Departure,0,0,0,0
8/20/2020,Q3,5,H,Hong Kong-Zhuhai-Macao Bridge,Arrival,43,2,12,57
8/20/2020,Q3,5,H,Hong Kong-Zhuhai-Macao Bridge,Departure,142,3,6,151
8/20/2020,Q3,5,H,Lok Ma Chau,Arrival,0,0,0,0
8/20/2020,Q3,5,H,Lok Ma Chau,Departure,0,0,0,0
8/20/2020,Q3,5,H,Man Kam To,Arrival,0,0,0,0
8/20/2020,Q3,5,H,Man Kam To,Departure,0,0,0,0
8/20/2020,Q3,5,H,Sha Tau Kok,Arrival,0,0,0,0
8/20/2020,Q3,5,H,Sha Tau Kok,Departure,0,0,0,0
8/20/2020,Q3,5,H,Shenzhen Bay,Arrival,605,84,2,691
8/20/2020,Q3,5,H,Shenzhen Bay,Departure,741,98,5,844
8/20/2020,Q3,5,H,China Ferry Terminal,Arrival,0,0,0,0
8/20/2020,Q3,5,H,China Ferry Terminal,Departure,0,0,0,0
8/20/2020,Q3,5,H,Harbour Control,Arrival,0,0,0,0
8/20/2020,Q3,5,H,Harbour Control,Departure,0,0,0,0
8/20/2020,Q3,5,H,Kai Tak Cruise Terminal,Arrival,0,0,0,0
8/20/2020,Q3,5,H,Kai Tak Cruise Terminal,Departure,0,0,0,0
8/20/2020,Q3,5,H,Macau Ferry Terminal,Arrival,0,0,0,0
8/20/2020,Q3,5,H,Macau Ferry Terminal,Departure,0,0,0,0
8/20/2020,Q3,5,H,Tuen Mun Ferry Terminal,Arrival,0,0,0,0
8/20/2020,Q3,5,H,Tuen Mun Ferry Terminal,Departure,0,0,0,0
8/21/2020,Q3,5,H,Airport,Arrival,722,10,25,757
8/21/2020,Q3,5,H,Airport,Departure,1681,27,184,1892
8/21/2020,Q3,5,H,Express Rail Link West Kowloon,Arrival,0,0,0,0
8/21/2020,Q3,5,H,Express Rail Link West Kowloon,Departure,0,0,0,0
8/21/2020,Q3,5,H,Hung Hom,Arrival,0,0,0,0
8/21/2020,Q3,5,H,Hung Hom,Departure,0,0,0,0
8/21/2020,Q3,5,H,Lo Wu,Arrival,0,0,0,0
8/21/2020,Q3,5,H,Lo Wu,Departure,0,0,0,0
8/21/2020,Q3,5,H,Lok Ma Chau Spur Line,Arrival,0,0,0,0
8/21/2020,Q3,5,H,Lok Ma Chau Spur Line,Departure,0,0,0,0
8/21/2020,Q3,5,H,Hong Kong-Zhuhai-Macao Bridge,Arrival,54,3,89,146
8/21/2020,Q3,5,H,Hong Kong-Zhuhai-Macao Bridge,Departure,164,7,5,176
8/21/2020,Q3,5,H,Lok Ma Chau,Arrival,0,0,0,0
8/21/2020,Q3,5,H,Lok Ma Chau,Departure,0,0,0,0
8/21/2020,Q3,5,H,Man Kam To,Arrival,0,0,0,0
8/21/2020,Q3,5,H,Man Kam To,Departure,0,0,0,0
8/21/2020,Q3,5,H,Sha Tau Kok,Arrival,0,0,0,0
8/21/2020,Q3,5,H,Sha Tau Kok,Departure,0,0,0,0
8/21/2020,Q3,5,H,Shenzhen Bay,Arrival,612,56,3,671
8/21/2020,Q3,5,H,Shenzhen Bay,Departure,715,75,3,793
8/21/2020,Q3,5,H,China Ferry Terminal,Arrival,0,0,0,0
8/21/2020,Q3,5,H,China Ferry Terminal,Departure,0,0,0,0
8/21/2020,Q3,5,H,Harbour Control,Arrival,0,0,0,0
8/21/2020,Q3,5,H,Harbour Control,Departure,0,0,0,0
8/21/2020,Q3,5,H,Kai Tak Cruise Terminal,Arrival,0,0,0,0
8/21/2020,Q3,5,H,Kai Tak Cruise Terminal,Departure,0,0,0,0
8/21/2020,Q3,5,H,Macau Ferry Terminal,Arrival,0,0,0,0
8/21/2020,Q3,5,H,Macau Ferry Terminal,Departure,0,0,0,0
8/21/2020,Q3,5,H,Tuen Mun Ferry Terminal,Arrival,0,0,0,0
8/21/2020,Q3,5,H,Tuen Mun Ferry Terminal,Departure,0,0,0,0
8/22/2020,Q3,5,H,Airport,Arrival,570,1,12,583
8/22/2020,Q3,5,H,Airport,Departure,1530,26,48,1604
8/22/2020,Q3,5,H,Express Rail Link West Kowloon,Arrival,0,0,0,0
8/22/2020,Q3,5,H,Express Rail Link West Kowloon,Departure,0,0,0,0
8/22/2020,Q3,5,H,Hung Hom,Arrival,0,0,0,0
8/22/2020,Q3,5,H,Hung Hom,Departure,0,0,0,0
8/22/2020,Q3,5,H,Lo Wu,Arrival,0,0,0,0
8/22/2020,Q3,5,H,Lo Wu,Departure,0,0,0,0
8/22/2020,Q3,5,H,Lok Ma Chau Spur Line,Arrival,0,0,0,0
8/22/2020,Q3,5,H,Lok Ma Chau Spur Line,Departure,0,0,0,0
8/22/2020,Q3,5,H,Hong Kong-Zhuhai-Macao Bridge,Arrival,41,4,5,50
8/22/2020,Q3,5,H,Hong Kong-Zhuhai-Macao Bridge,Departure,182,5,9,196
8/22/2020,Q3,5,H,Lok Ma Chau,Arrival,0,0,0,0
8/22/2020,Q3,5,H,Lok Ma Chau,Departure,0,0,0,0
8/22/2020,Q3,5,H,Man Kam To,Arrival,0,0,0,0
8/22/2020,Q3,5,H,Man Kam To,Departure,0,0,0,0
8/22/2020,Q3,5,H,Sha Tau Kok,Arrival,0,0,0,0
8/22/2020,Q3,5,H,Sha Tau Kok,Departure,0,0,0,0
8/22/2020,Q3,5,H,Shenzhen Bay,Arrival,502,78,3,583
8/22/2020,Q3,5,H,Shenzhen Bay,Departure,801,108,1,910
8/22/2020,Q3,5,H,China Ferry Terminal,Arrival,0,0,0,0
8/22/2020,Q3,5,H,China Ferry Terminal,Departure,0,0,0,0
8/22/2020,Q3,5,H,Harbour Control,Arrival,0,0,0,0
8/22/2020,Q3,5,H,Harbour Control,Departure,0,0,0,0
8/22/2020,Q3,5,H,Kai Tak Cruise Terminal,Arrival,0,0,0,0
8/22/2020,Q3,5,H,Kai Tak Cruise Terminal,Departure,0,0,0,0
8/22/2020,Q3,5,H,Macau Ferry Terminal,Arrival,0,0,0,0
8/22/2020,Q3,5,H,Macau Ferry Terminal,Departure,0,0,0,0
8/22/2020,Q3,5,H,Tuen Mun Ferry Terminal,Arrival,0,0,0,0
8/22/2020,Q3,5,H,Tuen Mun Ferry Terminal,Departure,0,0,0,0
8/23/2020,Q3,5,H,Airport,Arrival,865,10,48,923
8/23/2020,Q3,5,H,Airport,Departure,1790,27,60,1877
8/23/2020,Q3,5,H,Express Rail Link West Kowloon,Arrival,0,0,0,0
8/23/2020,Q3,5,H,Express Rail Link West Kowloon,Departure,0,0,0,0
8/23/2020,Q3,5,H,Hung Hom,Arrival,0,0,0,0
8/23/2020,Q3,5,H,Hung Hom,Departure,0,0,0,0
8/23/2020,Q3,5,H,Lo Wu,Arrival,0,0,0,0
8/23/2020,Q3,5,H,Lo Wu,Departure,0,0,0,0
8/23/2020,Q3,5,H,Lok Ma Chau Spur Line,Arrival,0,0,0,0
8/23/2020,Q3,5,H,Lok Ma Chau Spur Line,Departure,0,0,0,0
8/23/2020,Q3,5,H,Hong Kong-Zhuhai-Macao Bridge,Arrival,52,1,0,53
8/23/2020,Q3,5,H,Hong Kong-Zhuhai-Macao Bridge,Departure,117,8,1,126
8/23/2020,Q3,5,H,Lok Ma Chau,Arrival,0,0,0,0
8/23/2020,Q3,5,H,Lok Ma Chau,Departure,0,0,0,0
8/23/2020,Q3,5,H,Man Kam To,Arrival,0,0,0,0
8/23/2020,Q3,5,H,Man Kam To,Departure,0,0,0,0
8/23/2020,Q3,5,H,Sha Tau Kok,Arrival,0,0,0,0
8/23/2020,Q3,5,H,Sha Tau Kok,Departure,0,0,0,0
8/23/2020,Q3,5,H,Shenzhen Bay,Arrival,634,68,8,710
8/23/2020,Q3,5,H,Shenzhen Bay,Departure,458,58,3,519
8/23/2020,Q3,5,H,China Ferry Terminal,Arrival,0,0,0,0
8/23/2020,Q3,5,H,China Ferry Terminal,Departure,0,0,0,0
8/23/2020,Q3,5,H,Harbour Control,Arrival,0,0,0,0
8/23/2020,Q3,5,H,Harbour Control,Departure,0,0,0,0
8/23/2020,Q3,5,H,Kai Tak Cruise Terminal,Arrival,0,0,0,0
8/23/2020,Q3,5,H,Kai Tak Cruise Terminal,Departure,0,0,0,0
8/23/2020,Q3,5,H,Macau Ferry Terminal,Arrival,0,0,0,0
8/23/2020,Q3,5,H,Macau Ferry Terminal,Departure,0,0,0,0
8/23/2020,Q3,5,H,Tuen Mun Ferry Terminal,Arrival,0,0,0,0
8/23/2020,Q3,5,H,Tuen Mun Ferry Terminal,Departure,0,0,0,0
8/24/2020,Q3,5,H,Airport,Arrival,611,8,9,628
8/24/2020,Q3,5,H,Airport,Departure,1045,22,81,1148
8/24/2020,Q3,5,H,Express Rail Link West Kowloon,Arrival,0,0,0,0
8/24/2020,Q3,5,H,Express Rail Link West Kowloon,Departure,0,0,0,0
8/24/2020,Q3,5,H,Hung Hom,Arrival,0,0,0,0
8/24/2020,Q3,5,H,Hung Hom,Departure,0,0,0,0
8/24/2020,Q3,5,H,Lo Wu,Arrival,0,0,0,0
8/24/2020,Q3,5,H,Lo Wu,Departure,0,0,0,0
8/24/2020,Q3,5,H,Lok Ma Chau Spur Line,Arrival,0,0,0,0
8/24/2020,Q3,5,H,Lok Ma Chau Spur Line,Departure,0,0,0,0
8/24/2020,Q3,5,H,Hong Kong-Zhuhai-Macao Bridge,Arrival,46,1,2,49
8/24/2020,Q3,5,H,Hong Kong-Zhuhai-Macao Bridge,Departure,84,6,8,98
8/24/2020,Q3,5,H,Lok Ma Chau,Arrival,0,0,0,0
8/24/2020,Q3,5,H,Lok Ma Chau,Departure,0,0,0,0
8/24/2020,Q3,5,H,Man Kam To,Arrival,0,0,0,0
8/24/2020,Q3,5,H,Man Kam To,Departure,0,0,0,0
8/24/2020,Q3,5,H,Sha Tau Kok,Arrival,0,0,0,0
8/24/2020,Q3,5,H,Sha Tau Kok,Departure,0,0,0,0
8/24/2020,Q3,5,H,Shenzhen Bay,Arrival,614,47,5,666
8/24/2020,Q3,5,H,Shenzhen Bay,Departure,395,48,3,446
8/24/2020,Q3,5,H,China Ferry Terminal,Arrival,0,0,0,0
8/24/2020,Q3,5,H,China Ferry Terminal,Departure,0,0,0,0
8/24/2020,Q3,5,H,Harbour Control,Arrival,0,0,0,0
8/24/2020,Q3,5,H,Harbour Control,Departure,0,0,0,0
8/24/2020,Q3,5,H,Kai Tak Cruise Terminal,Arrival,0,0,0,0
8/24/2020,Q3,5,H,Kai Tak Cruise Terminal,Departure,0,0,0,0
8/24/2020,Q3,5,H,Macau Ferry Terminal,Arrival,0,0,0,0
8/24/2020,Q3,5,H,Macau Ferry Terminal,Departure,0,0,0,0
8/24/2020,Q3,5,H,Tuen Mun Ferry Terminal,Arrival,0,0,0,0
8/24/2020,Q3,5,H,Tuen Mun Ferry Terminal,Departure,0,0,0,0
8/25/2020,Q3,5,H,Airport,Arrival,433,9,10,452
8/25/2020,Q3,5,H,Airport,Departure,1498,19,91,1608
8/25/2020,Q3,5,H,Express Rail Link West Kowloon,Arrival,0,0,0,0
8/25/2020,Q3,5,H,Express Rail Link West Kowloon,Departure,0,0,0,0
8/25/2020,Q3,5,H,Hung Hom,Arrival,0,0,0,0
8/25/2020,Q3,5,H,Hung Hom,Departure,0,0,0,0
8/25/2020,Q3,5,H,Lo Wu,Arrival,0,0,0,0
8/25/2020,Q3,5,H,Lo Wu,Departure,0,0,0,0
8/25/2020,Q3,5,H,Lok Ma Chau Spur Line,Arrival,0,0,0,0
8/25/2020,Q3,5,H,Lok Ma Chau Spur Line,Departure,0,0,0,0
8/25/2020,Q3,5,H,Hong Kong-Zhuhai-Macao Bridge,Arrival,55,4,3,62
8/25/2020,Q3,5,H,Hong Kong-Zhuhai-Macao Bridge,Departure,131,7,6,144
8/25/2020,Q3,5,H,Lok Ma Chau,Arrival,0,0,0,0
8/25/2020,Q3,5,H,Lok Ma Chau,Departure,0,0,0,0
8/25/2020,Q3,5,H,Man Kam To,Arrival,0,0,0,0
8/25/2020,Q3,5,H,Man Kam To,Departure,0,0,0,0
8/25/2020,Q3,5,H,Sha Tau Kok,Arrival,0,0,0,0
8/25/2020,Q3,5,H,Sha Tau Kok,Departure,0,0,0,0
8/25/2020,Q3,5,H,Shenzhen Bay,Arrival,588,61,4,653
8/25/2020,Q3,5,H,Shenzhen Bay,Departure,610,59,6,675
8/25/2020,Q3,5,H,China Ferry Terminal,Arrival,0,0,0,0
8/25/2020,Q3,5,H,China Ferry Terminal,Departure,0,0,0,0
8/25/2020,Q3,5,H,Harbour Control,Arrival,0,0,0,0
8/25/2020,Q3,5,H,Harbour Control,Departure,0,0,0,0
8/25/2020,Q3,5,H,Kai Tak Cruise Terminal,Arrival,0,0,0,0
8/25/2020,Q3,5,H,Kai Tak Cruise Terminal,Departure,0,0,0,0
8/25/2020,Q3,5,H,Macau Ferry Terminal,Arrival,0,0,0,0
8/25/2020,Q3,5,H,Macau Ferry Terminal,Departure,0,0,0,0
8/25/2020,Q3,5,H,Tuen Mun Ferry Terminal,Arrival,0,0,0,0
8/25/2020,Q3,5,H,Tuen Mun Ferry Terminal,Departure,0,0,0,0
8/26/2020,Q3,5,H,Airport,Arrival,588,2,30,620
8/26/2020,Q3,5,H,Airport,Departure,1002,10,56,1068
8/26/2020,Q3,5,H,Express Rail Link West Kowloon,Arrival,0,0,0,0
8/26/2020,Q3,5,H,Express Rail Link West Kowloon,Departure,0,0,0,0
8/26/2020,Q3,5,H,Hung Hom,Arrival,0,0,0,0
8/26/2020,Q3,5,H,Hung Hom,Departure,0,0,0,0
8/26/2020,Q3,5,H,Lo Wu,Arrival,0,0,0,0
8/26/2020,Q3,5,H,Lo Wu,Departure,0,0,0,0
8/26/2020,Q3,5,H,Lok Ma Chau Spur Line,Arrival,0,0,0,0
8/26/2020,Q3,5,H,Lok Ma Chau Spur Line,Departure,0,0,0,0
8/26/2020,Q3,5,H,Heung Yuen Wai,Arrival,0,0,0,0
8/26/2020,Q3,5,H,Heung Yuen Wai,Departure,0,0,0,0
8/26/2020,Q3,5,H,Hong Kong-Zhuhai-Macao Bridge,Arrival,59,2,3,64
8/26/2020,Q3,5,H,Hong Kong-Zhuhai-Macao Bridge,Departure,162,10,2,174
8/26/2020,Q3,5,H,Lok Ma Chau,Arrival,0,0,0,0
8/26/2020,Q3,5,H,Lok Ma Chau,Departure,0,0,0,0
8/26/2020,Q3,5,H,Man Kam To,Arrival,0,0,0,0
8/26/2020,Q3,5,H,Man Kam To,Departure,0,0,0,0
8/26/2020,Q3,5,H,Sha Tau Kok,Arrival,0,0,0,0
8/26/2020,Q3,5,H,Sha Tau Kok,Departure,0,0,0,0
8/26/2020,Q3,5,H,Shenzhen Bay,Arrival,658,61,2,721
8/26/2020,Q3,5,H,Shenzhen Bay,Departure,771,84,4,859
8/26/2020,Q3,5,H,China Ferry Terminal,Arrival,0,0,0,0
8/26/2020,Q3,5,H,China Ferry Terminal,Departure,0,0,0,0
8/26/2020,Q3,5,H,Harbour Control,Arrival,0,0,0,0
8/26/2020,Q3,5,H,Harbour Control,Departure,0,0,0,0
8/26/2020,Q3,5,H,Kai Tak Cruise Terminal,Arrival,0,0,0,0
8/26/2020,Q3,5,H,Kai Tak Cruise Terminal,Departure,0,0,0,0
8/26/2020,Q3,5,H,Macau Ferry Terminal,Arrival,0,0,0,0
8/26/2020,Q3,5,H,Macau Ferry Terminal,Departure,0,0,0,0
8/26/2020,Q3,5,H,Tuen Mun Ferry Terminal,Arrival,0,0,0,0
8/26/2020,Q3,5,H,Tuen Mun Ferry Terminal,Departure,0,0,0,0
8/27/2020,Q3,5,H,Airport,Arrival,628,4,13,645
8/27/2020,Q3,5,H,Airport,Departure,1292,3,49,1344
8/27/2020,Q3,5,H,Express Rail Link West Kowloon,Arrival,0,0,0,0
8/27/2020,Q3,5,H,Express Rail Link West Kowloon,Departure,0,0,0,0
8/27/2020,Q3,5,H,Hung Hom,Arrival,0,0,0,0
8/27/2020,Q3,5,H,Hung Hom,Departure,0,0,0,0
8/27/2020,Q3,5,H,Lo Wu,Arrival,0,0,0,0
8/27/2020,Q3,5,H,Lo Wu,Departure,0,0,0,0
8/27/2020,Q3,5,H,Lok Ma Chau Spur Line,Arrival,0,0,0,0
8/27/2020,Q3,5,H,Lok Ma Chau Spur Line,Departure,0,0,0,0
8/27/2020,Q3,5,H,Heung Yuen Wai,Arrival,0,0,0,0
8/27/2020,Q3,5,H,Heung Yuen Wai,Departure,0,0,0,0
8/27/2020,Q3,5,H,Hong Kong-Zhuhai-Macao Bridge,Arrival,67,1,2,70
8/27/2020,Q3,5,H,Hong Kong-Zhuhai-Macao Bridge,Departure,125,12,6,143
8/27/2020,Q3,5,H,Lok Ma Chau,Arrival,0,0,0,0
8/27/2020,Q3,5,H,Lok Ma Chau,Departure,0,0,0,0
8/27/2020,Q3,5,H,Man Kam To,Arrival,0,0,0,0
8/27/2020,Q3,5,H,Man Kam To,Departure,0,0,0,0
8/27/2020,Q3,5,H,Sha Tau Kok,Arrival,0,0,0,0
8/27/2020,Q3,5,H,Sha Tau Kok,Departure,0,0,0,0
8/27/2020,Q3,5,H,Shenzhen Bay,Arrival,587,70,4,661
8/27/2020,Q3,5,H,Shenzhen Bay,Departure,716,67,3,786
8/27/2020,Q3,5,H,China Ferry Terminal,Arrival,0,0,0,0
8/27/2020,Q3,5,H,China Ferry Terminal,Departure,0,0,0,0
8/27/2020,Q3,5,H,Harbour Control,Arrival,0,0,0,0
8/27/2020,Q3,5,H,Harbour Control,Departure,0,0,0,0
8/27/2020,Q3,5,H,Kai Tak Cruise Terminal,Arrival,0,0,0,0
8/27/2020,Q3,5,H,Kai Tak Cruise Terminal,Departure,0,0,0,0
8/27/2020,Q3,5,H,Macau Ferry Terminal,Arrival,0,0,0,0
8/27/2020,Q3,5,H,Macau Ferry Terminal,Departure,0,0,0,0
8/27/2020,Q3,5,H,Tuen Mun Ferry Terminal,Arrival,0,0,0,0
8/27/2020,Q3,5,H,Tuen Mun Ferry Terminal,Departure,0,0,0,0
8/28/2020,Q3,5,H,Airport,Arrival,795,9,35,839
8/28/2020,Q3,5,H,Airport,Departure,1624,13,82,1719
8/28/2020,Q3,5,H,Express Rail Link West Kowloon,Arrival,0,0,0,0
8/28/2020,Q3,5,H,Express Rail Link West Kowloon,Departure,0,0,0,0
8/28/2020,Q3,5,H,Hung Hom,Arrival,0,0,0,0
8/28/2020,Q3,5,H,Hung Hom,Departure,0,0,0,0
8/28/2020,Q3,5,H,Lo Wu,Arrival,0,0,0,0
8/28/2020,Q3,5,H,Lo Wu,Departure,0,0,0,0
8/28/2020,Q3,5,H,Lok Ma Chau Spur Line,Arrival,0,0,0,0
8/28/2020,Q3,5,H,Lok Ma Chau Spur Line,Departure,0,0,0,0
8/28/2020,Q3,5,H,Heung Yuen Wai,Arrival,0,0,0,0
8/28/2020,Q3,5,H,Heung Yuen Wai,Departure,0,0,0,0
8/28/2020,Q3,5,H,Hong Kong-Zhuhai-Macao Bridge,Arrival,64,1,1,66
8/28/2020,Q3,5,H,Hong Kong-Zhuhai-Macao Bridge,Departure,118,4,11,133
8/28/2020,Q3,5,H,Lok Ma Chau,Arrival,0,0,0,0
8/28/2020,Q3,5,H,Lok Ma Chau,Departure,0,0,0,0
8/28/2020,Q3,5,H,Man Kam To,Arrival,0,0,0,0
8/28/2020,Q3,5,H,Man Kam To,Departure,0,0,0,0
8/28/2020,Q3,5,H,Sha Tau Kok,Arrival,0,0,0,0
8/28/2020,Q3,5,H,Sha Tau Kok,Departure,0,0,0,0
8/28/2020,Q3,5,H,Shenzhen Bay,Arrival,867,88,8,963
8/28/2020,Q3,5,H,Shenzhen Bay,Departure,562,75,4,641
8/28/2020,Q3,5,H,China Ferry Terminal,Arrival,0,0,0,0
8/28/2020,Q3,5,H,China Ferry Terminal,Departure,0,0,0,0
8/28/2020,Q3,5,H,Harbour Control,Arrival,0,0,0,0
8/28/2020,Q3,5,H,Harbour Control,Departure,0,0,0,0
8/28/2020,Q3,5,H,Kai Tak Cruise Terminal,Arrival,0,0,0,0
8/28/2020,Q3,5,H,Kai Tak Cruise Terminal,Departure,0,0,0,0
8/28/2020,Q3,5,H,Macau Ferry Terminal,Arrival,0,0,0,0
8/28/2020,Q3,5,H,Macau Ferry Terminal,Departure,0,0,0,0
8/28/2020,Q3,5,H,Tuen Mun Ferry Terminal,Arrival,0,0,0,0
8/28/2020,Q3,5,H,Tuen Mun Ferry Terminal,Departure,0,0,0,0
8/29/2020,Q3,5,H,Airport,Arrival,805,4,17,826
8/29/2020,Q3,5,H,Airport,Departure,1912,42,224,2178
8/29/2020,Q3,5,H,Express Rail Link West Kowloon,Arrival,0,0,0,0
8/29/2020,Q3,5,H,Express Rail Link West Kowloon,Departure,0,0,0,0
8/29/2020,Q3,5,H,Hung Hom,Arrival,0,0,0,0
8/29/2020,Q3,5,H,Hung Hom,Departure,0,0,0,0
8/29/2020,Q3,5,H,Lo Wu,Arrival,0,0,0,0
8/29/2020,Q3,5,H,Lo Wu,Departure,0,0,0,0
8/29/2020,Q3,5,H,Lok Ma Chau Spur Line,Arrival,0,0,0,0
8/29/2020,Q3,5,H,Lok Ma Chau Spur Line,Departure,0,0,0,0
8/29/2020,Q3,5,H,Heung Yuen Wai,Arrival,0,0,0,0
8/29/2020,Q3,5,H,Heung Yuen Wai,Departure,0,0,0,0
8/29/2020,Q3,5,H,Hong Kong-Zhuhai-Macao Bridge,Arrival,68,3,13,84
8/29/2020,Q3,5,H,Hong Kong-Zhuhai-Macao Bridge,Departure,132,11,9,152
8/29/2020,Q3,5,H,Lok Ma Chau,Arrival,0,0,0,0
8/29/2020,Q3,5,H,Lok Ma Chau,Departure,0,0,0,0
8/29/2020,Q3,5,H,Man Kam To,Arrival,0,0,0,0
8/29/2020,Q3,5,H,Man Kam To,Departure,0,0,0,0
8/29/2020,Q3,5,H,Sha Tau Kok,Arrival,0,0,0,0
8/29/2020,Q3,5,H,Sha Tau Kok,Departure,0,0,0,0
8/29/2020,Q3,5,H,Shenzhen Bay,Arrival,755,95,2,852
8/29/2020,Q3,5,H,Shenzhen Bay,Departure,452,53,2,507
8/29/2020,Q3,5,H,China Ferry Terminal,Arrival,0,0,0,0
8/29/2020,Q3,5,H,China Ferry Terminal,Departure,0,0,0,0
8/29/2020,Q3,5,H,Harbour Control,Arrival,0,0,0,0
8/29/2020,Q3,5,H,Harbour Control,Departure,0,0,0,0
8/29/2020,Q3,5,H,Kai Tak Cruise Terminal,Arrival,0,0,0,0
8/29/2020,Q3,5,H,Kai Tak Cruise Terminal,Departure,0,0,0,0
8/29/2020,Q3,5,H,Macau Ferry Terminal,Arrival,0,0,0,0
8/29/2020,Q3,5,H,Macau Ferry Terminal,Departure,0,0,0,0
8/29/2020,Q3,5,H,Tuen Mun Ferry Terminal,Arrival,0,0,0,0
8/29/2020,Q3,5,H,Tuen Mun Ferry Terminal,Departure,0,0,0,0
8/30/2020,Q3,5,H,Airport,Arrival,1031,9,32,1072
8/30/2020,Q3,5,H,Airport,Departure,1645,10,57,1712
8/30/2020,Q3,5,H,Express Rail Link West Kowloon,Arrival,0,0,0,0
8/30/2020,Q3,5,H,Express Rail Link West Kowloon,Departure,0,0,0,0
8/30/2020,Q3,5,H,Hung Hom,Arrival,0,0,0,0
8/30/2020,Q3,5,H,Hung Hom,Departure,0,0,0,0
8/30/2020,Q3,5,H,Lo Wu,Arrival,0,0,0,0
8/30/2020,Q3,5,H,Lo Wu,Departure,0,0,0,0
8/30/2020,Q3,5,H,Lok Ma Chau Spur Line,Arrival,0,0,0,0
8/30/2020,Q3,5,H,Lok Ma Chau Spur Line,Departure,0,0,0,0
8/30/2020,Q3,5,H,Heung Yuen Wai,Arrival,0,0,0,0
8/30/2020,Q3,5,H,Heung Yuen Wai,Departure,0,0,0,0
8/30/2020,Q3,5,H,Hong Kong-Zhuhai-Macao Bridge,Arrival,87,6,4,97
8/30/2020,Q3,5,H,Hong Kong-Zhuhai-Macao Bridge,Departure,78,4,5,87
8/30/2020,Q3,5,H,Lok Ma Chau,Arrival,0,0,0,0
8/30/2020,Q3,5,H,Lok Ma Chau,Departure,0,0,0,0
8/30/2020,Q3,5,H,Man Kam To,Arrival,0,0,0,0
8/30/2020,Q3,5,H,Man Kam To,Departure,0,0,0,0
8/30/2020,Q3,5,H,Sha Tau Kok,Arrival,0,0,0,0
8/30/2020,Q3,5,H,Sha Tau Kok,Departure,0,0,0,0
8/30/2020,Q3,5,H,Shenzhen Bay,Arrival,1160,113,1,1274
8/30/2020,Q3,5,H,Shenzhen Bay,Departure,377,39,1,417
8/30/2020,Q3,5,H,China Ferry Terminal,Arrival,0,0,0,0
8/30/2020,Q3,5,H,China Ferry Terminal,Departure,0,0,0,0
8/30/2020,Q3,5,H,Harbour Control,Arrival,0,0,0,0
8/30/2020,Q3,5,H,Harbour Control,Departure,0,0,0,0
8/30/2020,Q3,5,H,Kai Tak Cruise Terminal,Arrival,0,0,0,0
8/30/2020,Q3,5,H,Kai Tak Cruise Terminal,Departure,0,0,0,0
8/30/2020,Q3,5,H,Macau Ferry Terminal,Arrival,0,0,0,0
8/30/2020,Q3,5,H,Macau Ferry Terminal,Departure,0,0,0,0
8/30/2020,Q3,5,H,Tuen Mun Ferry Terminal,Arrival,0,0,0,0
8/30/2020,Q3,5,H,Tuen Mun Ferry Terminal,Departure,0,0,0,0
8/31/2020,Q3,5,H,Airport,Arrival,616,2,14,632
8/31/2020,Q3,5,H,Airport,Departure,1921,6,40,1967
8/31/2020,Q3,5,H,Express Rail Link West Kowloon,Arrival,0,0,0,0
8/31/2020,Q3,5,H,Express Rail Link West Kowloon,Departure,0,0,0,0
8/31/2020,Q3,5,H,Hung Hom,Arrival,0,0,0,0
8/31/2020,Q3,5,H,Hung Hom,Departure,0,0,0,0
8/31/2020,Q3,5,H,Lo Wu,Arrival,0,0,0,0
8/31/2020,Q3,5,H,Lo Wu,Departure,0,0,0,0
8/31/2020,Q3,5,H,Lok Ma Chau Spur Line,Arrival,0,0,0,0
8/31/2020,Q3,5,H,Lok Ma Chau Spur Line,Departure,0,0,0,0
8/31/2020,Q3,5,H,Heung Yuen Wai,Arrival,0,0,0,0
8/31/2020,Q3,5,H,Heung Yuen Wai,Departure,0,0,0,0
8/31/2020,Q3,5,H,Hong Kong-Zhuhai-Macao Bridge,Arrival,97,5,4,106
8/31/2020,Q3,5,H,Hong Kong-Zhuhai-Macao Bridge,Departure,84,5,2,91
8/31/2020,Q3,5,H,Lok Ma Chau,Arrival,0,0,0,0
8/31/2020,Q3,5,H,Lok Ma Chau,Departure,0,0,0,0
8/31/2020,Q3,5,H,Man Kam To,Arrival,0,0,0,0
8/31/2020,Q3,5,H,Man Kam To,Departure,0,0,0,0
8/31/2020,Q3,5,H,Sha Tau Kok,Arrival,0,0,0,0
8/31/2020,Q3,5,H,Sha Tau Kok,Departure,0,0,0,0
8/31/2020,Q3,5,H,Shenzhen Bay,Arrival,1276,96,2,1374
8/31/2020,Q3,5,H,Shenzhen Bay,Departure,417,43,4,464
8/31/2020,Q3,5,H,China Ferry Terminal,Arrival,0,0,0,0
8/31/2020,Q3,5,H,China Ferry Terminal,Departure,0,0,0,0
8/31/2020,Q3,5,H,Harbour Control,Arrival,0,0,0,0
8/31/2020,Q3,5,H,Harbour Control,Departure,0,0,0,0
8/31/2020,Q3,5,H,Kai Tak Cruise Terminal,Arrival,0,0,0,0
8/31/2020,Q3,5,H,Kai Tak Cruise Terminal,Departure,0,0,0,0
8/31/2020,Q3,5,H,Macau Ferry Terminal,Arrival,0,0,0,0
8/31/2020,Q3,5,H,Macau Ferry Terminal,Departure,0,0,0,0
8/31/2020,Q3,5,H,Tuen Mun Ferry Terminal,Arrival,0,0,0,0
8/31/2020,Q3,5,H,Tuen Mun Ferry Terminal,Departure,0,0,0,0
9/1/2020,Q3,5,H,Airport,Arrival,545,4,22,571
9/1/2020,Q3,5,H,Airport,Departure,1956,18,57,2031
9/1/2020,Q3,5,H,Express Rail Link West Kowloon,Arrival,0,0,0,0
9/1/2020,Q3,5,H,Express Rail Link West Kowloon,Departure,0,0,0,0
9/1/2020,Q3,5,H,Hung Hom,Arrival,0,0,0,0
9/1/2020,Q3,5,H,Hung Hom,Departure,0,0,0,0
9/1/2020,Q3,5,H,Lo Wu,Arrival,0,0,0,0
9/1/2020,Q3,5,H,Lo Wu,Departure,0,0,0,0
9/1/2020,Q3,5,H,Lok Ma Chau Spur Line,Arrival,0,0,0,0
9/1/2020,Q3,5,H,Lok Ma Chau Spur Line,Departure,0,0,0,0
9/1/2020,Q3,5,H,Heung Yuen Wai,Arrival,0,0,0,0
9/1/2020,Q3,5,H,Heung Yuen Wai,Departure,0,0,0,0
9/1/2020,Q3,5,H,Hong Kong-Zhuhai-Macao Bridge,Arrival,65,1,1,67
9/1/2020,Q3,5,H,Hong Kong-Zhuhai-Macao Bridge,Departure,138,4,7,149
9/1/2020,Q3,5,H,Lok Ma Chau,Arrival,0,0,0,0
9/1/2020,Q3,5,H,Lok Ma Chau,Departure,0,0,0,0
9/1/2020,Q3,5,H,Man Kam To,Arrival,0,0,0,0
9/1/2020,Q3,5,H,Man Kam To,Departure,0,0,0,0
9/1/2020,Q3,5,H,Sha Tau Kok,Arrival,0,0,0,0
9/1/2020,Q3,5,H,Sha Tau Kok,Departure,0,0,0,0
9/1/2020,Q3,5,H,Shenzhen Bay,Arrival,816,72,2,890
9/1/2020,Q3,5,H,Shenzhen Bay,Departure,643,73,7,723
9/1/2020,Q3,5,H,China Ferry Terminal,Arrival,0,0,0,0
9/1/2020,Q3,5,H,China Ferry Terminal,Departure,0,0,0,0
9/1/2020,Q3,5,H,Harbour Control,Arrival,0,0,0,0
9/1/2020,Q3,5,H,Harbour Control,Departure,0,0,0,0
9/1/2020,Q3,5,H,Kai Tak Cruise Terminal,Arrival,0,0,0,0
9/1/2020,Q3,5,H,Kai Tak Cruise Terminal,Departure,0,0,0,0
9/1/2020,Q3,5,H,Macau Ferry Terminal,Arrival,0,0,0,0
9/1/2020,Q3,5,H,Macau Ferry Terminal,Departure,0,0,0,0
9/1/2020,Q3,5,H,Tuen Mun Ferry Terminal,Arrival,0,0,0,0
9/1/2020,Q3,5,H,Tuen Mun Ferry Terminal,Departure,0,0,0,0
9/2/2020,Q3,5,H,Airport,Arrival,735,6,37,778
9/2/2020,Q3,5,H,Airport,Departure,1647,26,40,1713
9/2/2020,Q3,5,H,Express Rail Link West Kowloon,Arrival,0,0,0,0
9/2/2020,Q3,5,H,Express Rail Link West Kowloon,Departure,0,0,0,0
9/2/2020,Q3,5,H,Hung Hom,Arrival,0,0,0,0
9/2/2020,Q3,5,H,Hung Hom,Departure,0,0,0,0
9/2/2020,Q3,5,H,Lo Wu,Arrival,0,0,0,0
9/2/2020,Q3,5,H,Lo Wu,Departure,0,0,0,0
9/2/2020,Q3,5,H,Lok Ma Chau Spur Line,Arrival,0,0,0,0
9/2/2020,Q3,5,H,Lok Ma Chau Spur Line,Departure,0,0,0,0
9/2/2020,Q3,5,H,Heung Yuen Wai,Arrival,0,0,0,0
9/2/2020,Q3,5,H,Heung Yuen Wai,Departure,0,0,0,0
9/2/2020,Q3,5,H,Hong Kong-Zhuhai-Macao Bridge,Arrival,57,5,1,63
9/2/2020,Q3,5,H,Hong Kong-Zhuhai-Macao Bridge,Departure,140,10,1,151
9/2/2020,Q3,5,H,Lok Ma Chau,Arrival,0,0,0,0
9/2/2020,Q3,5,H,Lok Ma Chau,Departure,0,0,0,0
9/2/2020,Q3,5,H,Man Kam To,Arrival,0,0,0,0
9/2/2020,Q3,5,H,Man Kam To,Departure,0,0,0,0
9/2/2020,Q3,5,H,Sha Tau Kok,Arrival,0,0,0,0
9/2/2020,Q3,5,H,Sha Tau Kok,Departure,0,0,0,0
9/2/2020,Q3,5,H,Shenzhen Bay,Arrival,1012,89,2,1103
9/2/2020,Q3,5,H,Shenzhen Bay,Departure,710,82,2,794
9/2/2020,Q3,5,H,China Ferry Terminal,Arrival,0,0,0,0
9/2/2020,Q3,5,H,China Ferry Terminal,Departure,0,0,0,0
9/2/2020,Q3,5,H,Harbour Control,Arrival,0,0,0,0
9/2/2020,Q3,5,H,Harbour Control,Departure,0,0,0,0
9/2/2020,Q3,5,H,Kai Tak Cruise Terminal,Arrival,0,0,0,0
9/2/2020,Q3,5,H,Kai Tak Cruise Terminal,Departure,0,0,0,0
9/2/2020,Q3,5,H,Macau Ferry Terminal,Arrival,0,0,0,0
9/2/2020,Q3,5,H,Macau Ferry Terminal,Departure,0,0,0,0
9/2/2020,Q3,5,H,Tuen Mun Ferry Terminal,Arrival,0,0,0,0
9/2/2020,Q3,5,H,Tuen Mun Ferry Terminal,Departure,0,0,0,0
9/3/2020,Q3,5,H,Airport,Arrival,622,4,15,641
9/3/2020,Q3,5,H,Airport,Departure,1466,12,28,1506
9/3/2020,Q3,5,H,Express Rail Link West Kowloon,Arrival,0,0,0,0
9/3/2020,Q3,5,H,Express Rail Link West Kowloon,Departure,0,0,0,0
9/3/2020,Q3,5,H,Hung Hom,Arrival,0,0,0,0
9/3/2020,Q3,5,H,Hung Hom,Departure,0,0,0,0
9/3/2020,Q3,5,H,Lo Wu,Arrival,0,0,0,0
9/3/2020,Q3,5,H,Lo Wu,Departure,0,0,0,0
9/3/2020,Q3,5,H,Lok Ma Chau Spur Line,Arrival,0,0,0,0
9/3/2020,Q3,5,H,Lok Ma Chau Spur Line,Departure,0,0,0,0
9/3/2020,Q3,5,H,Heung Yuen Wai,Arrival,0,0,0,0
9/3/2020,Q3,5,H,Heung Yuen Wai,Departure,0,0,0,0
9/3/2020,Q3,5,H,Hong Kong-Zhuhai-Macao Bridge,Arrival,84,4,4,92
9/3/2020,Q3,5,H,Hong Kong-Zhuhai-Macao Bridge,Departure,141,7,2,150
9/3/2020,Q3,5,H,Lok Ma Chau,Arrival,0,0,0,0
9/3/2020,Q3,5,H,Lok Ma Chau,Departure,0,0,0,0
9/3/2020,Q3,5,H,Man Kam To,Arrival,0,0,0,0
9/3/2020,Q3,5,H,Man Kam To,Departure,0,0,0,0
9/3/2020,Q3,5,H,Sha Tau Kok,Arrival,0,0,0,0
9/3/2020,Q3,5,H,Sha Tau Kok,Departure,0,0,0,0
9/3/2020,Q3,5,H,Shenzhen Bay,Arrival,1032,79,4,1115
9/3/2020,Q3,5,H,Shenzhen Bay,Departure,756,86,7,849
9/3/2020,Q3,5,H,China Ferry Terminal,Arrival,0,0,0,0
9/3/2020,Q3,5,H,China Ferry Terminal,Departure,0,0,0,0
9/3/2020,Q3,5,H,Harbour Control,Arrival,0,0,0,0
9/3/2020,Q3,5,H,Harbour Control,Departure,0,0,0,0
9/3/2020,Q3,5,H,Kai Tak Cruise Terminal,Arrival,0,0,0,0
9/3/2020,Q3,5,H,Kai Tak Cruise Terminal,Departure,0,0,0,0
9/3/2020,Q3,5,H,Macau Ferry Terminal,Arrival,0,0,0,0
9/3/2020,Q3,5,H,Macau Ferry Terminal,Departure,0,0,0,0
9/3/2020,Q3,5,H,Tuen Mun Ferry Terminal,Arrival,0,0,0,0
9/3/2020,Q3,5,H,Tuen Mun Ferry Terminal,Departure,0,0,0,0
9/4/2020,Q3,5,H,Airport,Arrival,1231,5,32,1268
9/4/2020,Q3,5,H,Airport,Departure,1377,16,41,1434
9/4/2020,Q3,5,H,Express Rail Link West Kowloon,Arrival,0,0,0,0
9/4/2020,Q3,5,H,Express Rail Link West Kowloon,Departure,0,0,0,0
9/4/2020,Q3,5,H,Hung Hom,Arrival,0,0,0,0
9/4/2020,Q3,5,H,Hung Hom,Departure,0,0,0,0
9/4/2020,Q3,5,H,Lo Wu,Arrival,0,0,0,0
9/4/2020,Q3,5,H,Lo Wu,Departure,0,0,0,0
9/4/2020,Q3,5,H,Lok Ma Chau Spur Line,Arrival,0,0,0,0
9/4/2020,Q3,5,H,Lok Ma Chau Spur Line,Departure,0,0,0,0
9/4/2020,Q3,5,H,Heung Yuen Wai,Arrival,0,0,0,0
9/4/2020,Q3,5,H,Heung Yuen Wai,Departure,0,0,0,0
9/4/2020,Q3,5,H,Hong Kong-Zhuhai-Macao Bridge,Arrival,72,2,6,80
9/4/2020,Q3,5,H,Hong Kong-Zhuhai-Macao Bridge,Departure,175,6,9,190
9/4/2020,Q3,5,H,Lok Ma Chau,Arrival,0,0,0,0
9/4/2020,Q3,5,H,Lok Ma Chau,Departure,0,0,0,0
9/4/2020,Q3,5,H,Man Kam To,Arrival,0,0,0,0
9/4/2020,Q3,5,H,Man Kam To,Departure,0,0,0,0
9/4/2020,Q3,5,H,Sha Tau Kok,Arrival,0,0,0,0
9/4/2020,Q3,5,H,Sha Tau Kok,Departure,0,0,0,0
9/4/2020,Q3,5,H,Shenzhen Bay,Arrival,845,114,4,963
9/4/2020,Q3,5,H,Shenzhen Bay,Departure,695,80,2,777
9/4/2020,Q3,5,H,China Ferry Terminal,Arrival,0,0,0,0
9/4/2020,Q3,5,H,China Ferry Terminal,Departure,0,0,0,0
9/4/2020,Q3,5,H,Harbour Control,Arrival,0,0,0,0
9/4/2020,Q3,5,H,Harbour Control,Departure,0,0,0,0
9/4/2020,Q3,5,H,Kai Tak Cruise Terminal,Arrival,0,0,0,0
9/4/2020,Q3,5,H,Kai Tak Cruise Terminal,Departure,0,0,0,0
9/4/2020,Q3,5,H,Macau Ferry Terminal,Arrival,0,0,0,0
9/4/2020,Q3,5,H,Macau Ferry Terminal,Departure,0,0,0,0
9/4/2020,Q3,5,H,Tuen Mun Ferry Terminal,Arrival,0,0,0,0
9/4/2020,Q3,5,H,Tuen Mun Ferry Terminal,Departure,0,0,0,0
9/5/2020,Q3,5,H,Airport,Arrival,1046,11,28,1085
9/5/2020,Q3,5,H,Airport,Departure,1900,40,70,2010
9/5/2020,Q3,5,H,Express Rail Link West Kowloon,Arrival,0,0,0,0
9/5/2020,Q3,5,H,Express Rail Link West Kowloon,Departure,0,0,0,0
9/5/2020,Q3,5,H,Hung Hom,Arrival,0,0,0,0
9/5/2020,Q3,5,H,Hung Hom,Departure,0,0,0,0
9/5/2020,Q3,5,H,Lo Wu,Arrival,0,0,0,0
9/5/2020,Q3,5,H,Lo Wu,Departure,0,0,0,0
9/5/2020,Q3,5,H,Lok Ma Chau Spur Line,Arrival,0,0,0,0
9/5/2020,Q3,5,H,Lok Ma Chau Spur Line,Departure,0,0,0,0
9/5/2020,Q3,5,H,Heung Yuen Wai,Arrival,0,0,0,0
9/5/2020,Q3,5,H,Heung Yuen Wai,Departure,0,0,0,0
9/5/2020,Q3,5,H,Hong Kong-Zhuhai-Macao Bridge,Arrival,71,4,6,81
9/5/2020,Q3,5,H,Hong Kong-Zhuhai-Macao Bridge,Departure,100,6,6,112
9/5/2020,Q3,5,H,Lok Ma Chau,Arrival,0,0,0,0
9/5/2020,Q3,5,H,Lok Ma Chau,Departure,0,0,0,0
9/5/2020,Q3,5,H,Man Kam To,Arrival,0,0,0,0
9/5/2020,Q3,5,H,Man Kam To,Departure,0,0,0,0
9/5/2020,Q3,5,H,Sha Tau Kok,Arrival,0,0,0,0
9/5/2020,Q3,5,H,Sha Tau Kok,Departure,0,0,0,0
9/5/2020,Q3,5,H,Shenzhen Bay,Arrival,1401,154,5,1560
9/5/2020,Q3,5,H,Shenzhen Bay,Departure,550,82,3,635
9/5/2020,Q3,5,H,China Ferry Terminal,Arrival,0,0,0,0
9/5/2020,Q3,5,H,China Ferry Terminal,Departure,0,0,0,0
9/5/2020,Q3,5,H,Harbour Control,Arrival,0,0,0,0
9/5/2020,Q3,5,H,Harbour Control,Departure,0,0,0,0
9/5/2020,Q3,5,H,Kai Tak Cruise Terminal,Arrival,0,0,0,0
9/5/2020,Q3,5,H,Kai Tak Cruise Terminal,Departure,0,0,0,0
9/5/2020,Q3,5,H,Macau Ferry Terminal,Arrival,0,0,0,0
9/5/2020,Q3,5,H,Macau Ferry Terminal,Departure,0,0,0,0
9/5/2020,Q3,5,H,Tuen Mun Ferry Terminal,Arrival,0,0,0,0
9/5/2020,Q3,5,H,Tuen Mun Ferry Terminal,Departure,0,0,0,0
9/6/2020,Q3,5,H,Airport,Arrival,1093,5,51,1149
9/6/2020,Q3,5,H,Airport,Departure,1633,31,69,1733
9/6/2020,Q3,5,H,Express Rail Link West Kowloon,Arrival,0,0,0,0
9/6/2020,Q3,5,H,Express Rail Link West Kowloon,Departure,0,0,0,0
9/6/2020,Q3,5,H,Hung Hom,Arrival,0,0,0,0
9/6/2020,Q3,5,H,Hung Hom,Departure,0,0,0,0
9/6/2020,Q3,5,H,Lo Wu,Arrival,0,0,0,0
9/6/2020,Q3,5,H,Lo Wu,Departure,0,0,0,0
9/6/2020,Q3,5,H,Lok Ma Chau Spur Line,Arrival,0,0,0,0
9/6/2020,Q3,5,H,Lok Ma Chau Spur Line,Departure,0,0,0,0
9/6/2020,Q3,5,H,Heung Yuen Wai,Arrival,0,0,0,0
9/6/2020,Q3,5,H,Heung Yuen Wai,Departure,0,0,0,0
9/6/2020,Q3,5,H,Hong Kong-Zhuhai-Macao Bridge,Arrival,199,10,6,215
9/6/2020,Q3,5,H,Hong Kong-Zhuhai-Macao Bridge,Departure,39,3,0,42
9/6/2020,Q3,5,H,Lok Ma Chau,Arrival,0,0,0,0
9/6/2020,Q3,5,H,Lok Ma Chau,Departure,0,0,0,0
9/6/2020,Q3,5,H,Man Kam To,Arrival,0,0,0,0
9/6/2020,Q3,5,H,Man Kam To,Departure,0,0,0,0
9/6/2020,Q3,5,H,Sha Tau Kok,Arrival,0,0,0,0
9/6/2020,Q3,5,H,Sha Tau Kok,Departure,0,0,0,0
9/6/2020,Q3,5,H,Shenzhen Bay,Arrival,2543,257,12,2812
9/6/2020,Q3,5,H,Shenzhen Bay,Departure,337,44,2,383
9/6/2020,Q3,5,H,China Ferry Terminal,Arrival,0,0,0,0
9/6/2020,Q3,5,H,China Ferry Terminal,Departure,0,0,0,0
9/6/2020,Q3,5,H,Harbour Control,Arrival,0,0,0,0
9/6/2020,Q3,5,H,Harbour Control,Departure,0,0,0,0
9/6/2020,Q3,5,H,Kai Tak Cruise Terminal,Arrival,0,0,0,0
9/6/2020,Q3,5,H,Kai Tak Cruise Terminal,Departure,0,0,0,0
9/6/2020,Q3,5,H,Macau Ferry Terminal,Arrival,0,0,0,0
9/6/2020,Q3,5,H,Macau Ferry Terminal,Departure,0,0,0,0
9/6/2020,Q3,5,H,Tuen Mun Ferry Terminal,Arrival,0,0,0,0
9/6/2020,Q3,5,H,Tuen Mun Ferry Terminal,Departure,0,0,0,0
9/7/2020,Q3,5,H,Airport,Arrival,614,5,19,638
9/7/2020,Q3,5,H,Airport,Departure,1242,5,39,1286
9/7/2020,Q3,5,H,Express Rail Link West Kowloon,Arrival,0,0,0,0
9/7/2020,Q3,5,H,Express Rail Link West Kowloon,Departure,0,0,0,0
9/7/2020,Q3,5,H,Hung Hom,Arrival,0,0,0,0
9/7/2020,Q3,5,H,Hung Hom,Departure,0,0,0,0
9/7/2020,Q3,5,H,Lo Wu,Arrival,0,0,0,0
9/7/2020,Q3,5,H,Lo Wu,Departure,0,0,0,0
9/7/2020,Q3,5,H,Lok Ma Chau Spur Line,Arrival,0,0,0,0
9/7/2020,Q3,5,H,Lok Ma Chau Spur Line,Departure,0,0,0,0
9/7/2020,Q3,5,H,Heung Yuen Wai,Arrival,0,0,0,0
9/7/2020,Q3,5,H,Heung Yuen Wai,Departure,0,0,0,0
9/7/2020,Q3,5,H,Hong Kong-Zhuhai-Macao Bridge,Arrival,125,8,4,137
9/7/2020,Q3,5,H,Hong Kong-Zhuhai-Macao Bridge,Departure,71,3,1,75
9/7/2020,Q3,5,H,Lok Ma Chau,Arrival,0,0,0,0
9/7/2020,Q3,5,H,Lok Ma Chau,Departure,0,0,0,0
9/7/2020,Q3,5,H,Man Kam To,Arrival,0,0,0,0
9/7/2020,Q3,5,H,Man Kam To,Departure,0,0,0,0
9/7/2020,Q3,5,H,Sha Tau Kok,Arrival,0,0,0,0
9/7/2020,Q3,5,H,Sha Tau Kok,Departure,0,0,0,0
9/7/2020,Q3,5,H,Shenzhen Bay,Arrival,1680,170,6,1856
9/7/2020,Q3,5,H,Shenzhen Bay,Departure,360,43,2,405
9/7/2020,Q3,5,H,China Ferry Terminal,Arrival,0,0,0,0
9/7/2020,Q3,5,H,China Ferry Terminal,Departure,0,0,0,0
9/7/2020,Q3,5,H,Harbour Control,Arrival,0,0,0,0
9/7/2020,Q3,5,H,Harbour Control,Departure,0,0,0,0
9/7/2020,Q3,5,H,Kai Tak Cruise Terminal,Arrival,0,0,0,0
9/7/2020,Q3,5,H,Kai Tak Cruise Terminal,Departure,0,0,0,0
9/7/2020,Q3,5,H,Macau Ferry Terminal,Arrival,0,0,0,0
9/7/2020,Q3,5,H,Macau Ferry Terminal,Departure,0,0,0,0
9/7/2020,Q3,5,H,Tuen Mun Ferry Terminal,Arrival,0,0,0,0
9/7/2020,Q3,5,H,Tuen Mun Ferry Terminal,Departure,0,0,0,0
9/8/2020,Q3,5,H,Airport,Arrival,1030,9,45,1084
9/8/2020,Q3,5,H,Airport,Departure,1378,27,46,1451
9/8/2020,Q3,5,H,Express Rail Link West Kowloon,Arrival,0,0,0,0
9/8/2020,Q3,5,H,Express Rail Link West Kowloon,Departure,0,0,0,0
9/8/2020,Q3,5,H,Hung Hom,Arrival,0,0,0,0
9/8/2020,Q3,5,H,Hung Hom,Departure,0,0,0,0
9/8/2020,Q3,5,H,Lo Wu,Arrival,0,0,0,0
9/8/2020,Q3,5,H,Lo Wu,Departure,0,0,0,0
9/8/2020,Q3,5,H,Lok Ma Chau Spur Line,Arrival,0,0,0,0
9/8/2020,Q3,5,H,Lok Ma Chau Spur Line,Departure,0,0,0,0
9/8/2020,Q3,5,H,Heung Yuen Wai,Arrival,0,0,0,0
9/8/2020,Q3,5,H,Heung Yuen Wai,Departure,0,0,0,0
9/8/2020,Q3,5,H,Hong Kong-Zhuhai-Macao Bridge,Arrival,167,10,5,182
9/8/2020,Q3,5,H,Hong Kong-Zhuhai-Macao Bridge,Departure,114,12,3,129
9/8/2020,Q3,5,H,Lok Ma Chau,Arrival,0,0,0,0
9/8/2020,Q3,5,H,Lok Ma Chau,Departure,0,0,0,0
9/8/2020,Q3,5,H,Man Kam To,Arrival,0,0,0,0
9/8/2020,Q3,5,H,Man Kam To,Departure,0,0,0,0
9/8/2020,Q3,5,H,Sha Tau Kok,Arrival,0,0,0,0
9/8/2020,Q3,5,H,Sha Tau Kok,Departure,0,0,0,0
9/8/2020,Q3,5,H,Shenzhen Bay,Arrival,2340,290,7,2637
9/8/2020,Q3,5,H,Shenzhen Bay,Departure,735,64,7,806
9/8/2020,Q3,5,H,China Ferry Terminal,Arrival,0,0,0,0
9/8/2020,Q3,5,H,China Ferry Terminal,Departure,0,0,0,0
9/8/2020,Q3,5,H,Harbour Control,Arrival,0,0,0,0
9/8/2020,Q3,5,H,Harbour Control,Departure,0,0,0,0
9/8/2020,Q3,5,H,Kai Tak Cruise Terminal,Arrival,0,0,0,0
9/8/2020,Q3,5,H,Kai Tak Cruise Terminal,Departure,0,0,0,0
9/8/2020,Q3,5,H,Macau Ferry Terminal,Arrival,0,0,0,0
9/8/2020,Q3,5,H,Macau Ferry Terminal,Departure,0,0,0,0
9/8/2020,Q3,5,H,Tuen Mun Ferry Terminal,Arrival,0,0,0,0
9/8/2020,Q3,5,H,Tuen Mun Ferry Terminal,Departure,0,0,0,0
9/9/2020,Q3,5,H,Airport,Arrival,916,9,24,949
9/9/2020,Q3,5,H,Airport,Departure,1181,18,115,1314
9/9/2020,Q3,5,H,Express Rail Link West Kowloon,Arrival,0,0,0,0
9/9/2020,Q3,5,H,Express Rail Link West Kowloon,Departure,0,0,0,0
9/9/2020,Q3,5,H,Hung Hom,Arrival,0,0,0,0
9/9/2020,Q3,5,H,Hung Hom,Departure,0,0,0,0
9/9/2020,Q3,5,H,Lo Wu,Arrival,0,0,0,0
9/9/2020,Q3,5,H,Lo Wu,Departure,0,0,0,0
9/9/2020,Q3,5,H,Lok Ma Chau Spur Line,Arrival,0,0,0,0
9/9/2020,Q3,5,H,Lok Ma Chau Spur Line,Departure,0,0,0,0
9/9/2020,Q3,5,H,Heung Yuen Wai,Arrival,0,0,0,0
9/9/2020,Q3,5,H,Heung Yuen Wai,Departure,0,0,0,0
9/9/2020,Q3,5,H,Hong Kong-Zhuhai-Macao Bridge,Arrival,137,7,50,194
9/9/2020,Q3,5,H,Hong Kong-Zhuhai-Macao Bridge,Departure,113,9,3,125
9/9/2020,Q3,5,H,Lok Ma Chau,Arrival,0,0,0,0
9/9/2020,Q3,5,H,Lok Ma Chau,Departure,0,0,0,0
9/9/2020,Q3,5,H,Man Kam To,Arrival,0,0,0,0
9/9/2020,Q3,5,H,Man Kam To,Departure,0,0,0,0
9/9/2020,Q3,5,H,Sha Tau Kok,Arrival,0,0,0,0
9/9/2020,Q3,5,H,Sha Tau Kok,Departure,0,0,0,0
9/9/2020,Q3,5,H,Shenzhen Bay,Arrival,2182,291,9,2482
9/9/2020,Q3,5,H,Shenzhen Bay,Departure,636,96,4,736
9/9/2020,Q3,5,H,China Ferry Terminal,Arrival,0,0,0,0
9/9/2020,Q3,5,H,China Ferry Terminal,Departure,0,0,0,0
9/9/2020,Q3,5,H,Harbour Control,Arrival,0,0,0,0
9/9/2020,Q3,5,H,Harbour Control,Departure,0,0,0,0
9/9/2020,Q3,5,H,Kai Tak Cruise Terminal,Arrival,0,0,0,0
9/9/2020,Q3,5,H,Kai Tak Cruise Terminal,Departure,0,0,0,0
9/9/2020,Q3,5,H,Macau Ferry Terminal,Arrival,0,0,0,0
9/9/2020,Q3,5,H,Macau Ferry Terminal,Departure,0,0,0,0
9/9/2020,Q3,5,H,Tuen Mun Ferry Terminal,Arrival,0,0,0,0
9/9/2020,Q3,5,H,Tuen Mun Ferry Terminal,Departure,0,0,0,0
9/10/2020,Q3,5,H,Airport,Arrival,688,4,15,707
9/10/2020,Q3,5,H,Airport,Departure,1199,11,37,1247
9/10/2020,Q3,5,H,Express Rail Link West Kowloon,Arrival,0,0,0,0
9/10/2020,Q3,5,H,Express Rail Link West Kowloon,Departure,0,0,0,0
9/10/2020,Q3,5,H,Hung Hom,Arrival,0,0,0,0
9/10/2020,Q3,5,H,Hung Hom,Departure,0,0,0,0
9/10/2020,Q3,5,H,Lo Wu,Arrival,0,0,0,0
9/10/2020,Q3,5,H,Lo Wu,Departure,0,0,0,0
9/10/2020,Q3,5,H,Lok Ma Chau Spur Line,Arrival,0,0,0,0
9/10/2020,Q3,5,H,Lok Ma Chau Spur Line,Departure,0,0,0,0
9/10/2020,Q3,5,H,Heung Yuen Wai,Arrival,0,0,0,0
9/10/2020,Q3,5,H,Heung Yuen Wai,Departure,0,0,0,0
9/10/2020,Q3,5,H,Hong Kong-Zhuhai-Macao Bridge,Arrival,125,9,3,137
9/10/2020,Q3,5,H,Hong Kong-Zhuhai-Macao Bridge,Departure,136,7,7,150
9/10/2020,Q3,5,H,Lok Ma Chau,Arrival,0,0,0,0
9/10/2020,Q3,5,H,Lok Ma Chau,Departure,0,0,0,0
9/10/2020,Q3,5,H,Man Kam To,Arrival,0,0,0,0
9/10/2020,Q3,5,H,Man Kam To,Departure,0,0,0,0
9/10/2020,Q3,5,H,Sha Tau Kok,Arrival,0,0,0,0
9/10/2020,Q3,5,H,Sha Tau Kok,Departure,0,0,0,0
9/10/2020,Q3,5,H,Shenzhen Bay,Arrival,1317,171,7,1495
9/10/2020,Q3,5,H,Shenzhen Bay,Departure,612,84,6,702
9/10/2020,Q3,5,H,China Ferry Terminal,Arrival,0,0,0,0
9/10/2020,Q3,5,H,China Ferry Terminal,Departure,0,0,0,0
9/10/2020,Q3,5,H,Harbour Control,Arrival,0,0,0,0
9/10/2020,Q3,5,H,Harbour Control,Departure,0,0,0,0
9/10/2020,Q3,5,H,Kai Tak Cruise Terminal,Arrival,0,0,0,0
9/10/2020,Q3,5,H,Kai Tak Cruise Terminal,Departure,0,0,0,0
9/10/2020,Q3,5,H,Macau Ferry Terminal,Arrival,0,0,0,0
9/10/2020,Q3,5,H,Macau Ferry Terminal,Departure,0,0,0,0
9/10/2020,Q3,5,H,Tuen Mun Ferry Terminal,Arrival,0,0,0,0
9/10/2020,Q3,5,H,Tuen Mun Ferry Terminal,Departure,0,0,0,0
9/11/2020,Q3,5,H,Airport,Arrival,1166,7,44,1217
9/11/2020,Q3,5,H,Airport,Departure,1430,9,56,1495
9/11/2020,Q3,5,H,Express Rail Link West Kowloon,Arrival,0,0,0,0
9/11/2020,Q3,5,H,Express Rail Link West Kowloon,Departure,0,0,0,0
9/11/2020,Q3,5,H,Hung Hom,Arrival,0,0,0,0
9/11/2020,Q3,5,H,Hung Hom,Departure,0,0,0,0
9/11/2020,Q3,5,H,Lo Wu,Arrival,0,0,0,0
9/11/2020,Q3,5,H,Lo Wu,Departure,0,0,0,0
9/11/2020,Q3,5,H,Lok Ma Chau Spur Line,Arrival,0,0,0,0
9/11/2020,Q3,5,H,Lok Ma Chau Spur Line,Departure,0,0,0,0
9/11/2020,Q3,5,H,Heung Yuen Wai,Arrival,0,0,0,0
9/11/2020,Q3,5,H,Heung Yuen Wai,Departure,0,0,0,0
9/11/2020,Q3,5,H,Hong Kong-Zhuhai-Macao Bridge,Arrival,110,7,7,124
9/11/2020,Q3,5,H,Hong Kong-Zhuhai-Macao Bridge,Departure,133,8,2,143
9/11/2020,Q3,5,H,Lok Ma Chau,Arrival,0,0,0,0
9/11/2020,Q3,5,H,Lok Ma Chau,Departure,0,0,0,0
9/11/2020,Q3,5,H,Man Kam To,Arrival,0,0,0,0
9/11/2020,Q3,5,H,Man Kam To,Departure,0,0,0,0
9/11/2020,Q3,5,H,Sha Tau Kok,Arrival,0,0,0,0
9/11/2020,Q3,5,H,Sha Tau Kok,Departure,0,0,0,0
9/11/2020,Q3,5,H,Shenzhen Bay,Arrival,1213,180,6,1399
9/11/2020,Q3,5,H,Shenzhen Bay,Departure,537,89,5,631
9/11/2020,Q3,5,H,China Ferry Terminal,Arrival,0,0,0,0
9/11/2020,Q3,5,H,China Ferry Terminal,Departure,0,0,0,0
9/11/2020,Q3,5,H,Harbour Control,Arrival,0,0,0,0
9/11/2020,Q3,5,H,Harbour Control,Departure,0,0,0,0
9/11/2020,Q3,5,H,Kai Tak Cruise Terminal,Arrival,0,0,0,0
9/11/2020,Q3,5,H,Kai Tak Cruise Terminal,Departure,0,0,0,0
9/11/2020,Q3,5,H,Macau Ferry Terminal,Arrival,0,0,0,0
9/11/2020,Q3,5,H,Macau Ferry Terminal,Departure,0,0,0,0
9/11/2020,Q3,5,H,Tuen Mun Ferry Terminal,Arrival,0,0,0,0
9/11/2020,Q3,5,H,Tuen Mun Ferry Terminal,Departure,0,0,0,0
9/12/2020,Q3,5,H,Airport,Arrival,959,15,39,1013
9/12/2020,Q3,5,H,Airport,Departure,1457,40,46,1543
9/12/2020,Q3,5,H,Express Rail Link West Kowloon,Arrival,0,0,0,0
9/12/2020,Q3,5,H,Express Rail Link West Kowloon,Departure,0,0,0,0
9/12/2020,Q3,5,H,Hung Hom,Arrival,0,0,0,0
9/12/2020,Q3,5,H,Hung Hom,Departure,0,0,0,0
9/12/2020,Q3,5,H,Lo Wu,Arrival,0,0,0,0
9/12/2020,Q3,5,H,Lo Wu,Departure,0,0,0,0
9/12/2020,Q3,5,H,Lok Ma Chau Spur Line,Arrival,0,0,0,0
9/12/2020,Q3,5,H,Lok Ma Chau Spur Line,Departure,0,0,0,0
9/12/2020,Q3,5,H,Heung Yuen Wai,Arrival,0,0,0,0
9/12/2020,Q3,5,H,Heung Yuen Wai,Departure,0,0,0,0
9/12/2020,Q3,5,H,Hong Kong-Zhuhai-Macao Bridge,Arrival,109,13,5,127
9/12/2020,Q3,5,H,Hong Kong-Zhuhai-Macao Bridge,Departure,101,8,3,112
9/12/2020,Q3,5,H,Lok Ma Chau,Arrival,0,0,0,0
9/12/2020,Q3,5,H,Lok Ma Chau,Departure,0,0,0,0
9/12/2020,Q3,5,H,Man Kam To,Arrival,0,0,0,0
9/12/2020,Q3,5,H,Man Kam To,Departure,0,0,0,0
9/12/2020,Q3,5,H,Sha Tau Kok,Arrival,0,0,0,0
9/12/2020,Q3,5,H,Sha Tau Kok,Departure,0,0,0,0
9/12/2020,Q3,5,H,Shenzhen Bay,Arrival,1576,251,4,1831
9/12/2020,Q3,5,H,Shenzhen Bay,Departure,576,88,2,666
9/12/2020,Q3,5,H,China Ferry Terminal,Arrival,0,0,0,0
9/12/2020,Q3,5,H,China Ferry Terminal,Departure,0,0,0,0
9/12/2020,Q3,5,H,Harbour Control,Arrival,0,0,0,0
9/12/2020,Q3,5,H,Harbour Control,Departure,0,0,0,0
9/12/2020,Q3,5,H,Kai Tak Cruise Terminal,Arrival,0,0,0,0
9/12/2020,Q3,5,H,Kai Tak Cruise Terminal,Departure,0,0,0,0
9/12/2020,Q3,5,H,Macau Ferry Terminal,Arrival,0,0,0,0
9/12/2020,Q3,5,H,Macau Ferry Terminal,Departure,0,0,0,0
9/12/2020,Q3,5,H,Tuen Mun Ferry Terminal,Arrival,0,0,0,0
9/12/2020,Q3,5,H,Tuen Mun Ferry Terminal,Departure,0,0,0,0
9/13/2020,Q3,5,H,Airport,Arrival,1351,9,49,1409
9/13/2020,Q3,5,H,Airport,Departure,1426,29,60,1515
9/13/2020,Q3,5,H,Express Rail Link West Kowloon,Arrival,0,0,0,0
9/13/2020,Q3,5,H,Express Rail Link West Kowloon,Departure,0,0,0,0
9/13/2020,Q3,5,H,Hung Hom,Arrival,0,0,0,0
9/13/2020,Q3,5,H,Hung Hom,Departure,0,0,0,0
9/13/2020,Q3,5,H,Lo Wu,Arrival,0,0,0,0
9/13/2020,Q3,5,H,Lo Wu,Departure,0,0,0,0
9/13/2020,Q3,5,H,Lok Ma Chau Spur Line,Arrival,0,0,0,0
9/13/2020,Q3,5,H,Lok Ma Chau Spur Line,Departure,0,0,0,0
9/13/2020,Q3,5,H,Heung Yuen Wai,Arrival,0,0,0,0
9/13/2020,Q3,5,H,Heung Yuen Wai,Departure,0,0,0,0
9/13/2020,Q3,5,H,Hong Kong-Zhuhai-Macao Bridge,Arrival,229,20,7,256
9/13/2020,Q3,5,H,Hong Kong-Zhuhai-Macao Bridge,Departure,70,2,4,76
9/13/2020,Q3,5,H,Lok Ma Chau,Arrival,0,0,0,0
9/13/2020,Q3,5,H,Lok Ma Chau,Departure,0,0,0,0
9/13/2020,Q3,5,H,Man Kam To,Arrival,0,0,0,0
9/13/2020,Q3,5,H,Man Kam To,Departure,0,0,0,0
9/13/2020,Q3,5,H,Sha Tau Kok,Arrival,0,0,0,0
9/13/2020,Q3,5,H,Sha Tau Kok,Departure,0,0,0,0
9/13/2020,Q3,5,H,Shenzhen Bay,Arrival,3251,443,9,3703
9/13/2020,Q3,5,H,Shenzhen Bay,Departure,416,72,3,491
9/13/2020,Q3,5,H,China Ferry Terminal,Arrival,0,0,0,0
9/13/2020,Q3,5,H,China Ferry Terminal,Departure,0,0,0,0
9/13/2020,Q3,5,H,Harbour Control,Arrival,0,0,0,0
9/13/2020,Q3,5,H,Harbour Control,Departure,0,0,0,0
9/13/2020,Q3,5,H,Kai Tak Cruise Terminal,Arrival,0,0,0,0
9/13/2020,Q3,5,H,Kai Tak Cruise Terminal,Departure,0,0,0,0
9/13/2020,Q3,5,H,Macau Ferry Terminal,Arrival,0,0,0,0
9/13/2020,Q3,5,H,Macau Ferry Terminal,Departure,0,0,0,0
9/13/2020,Q3,5,H,Tuen Mun Ferry Terminal,Arrival,0,0,0,0
9/13/2020,Q3,5,H,Tuen Mun Ferry Terminal,Departure,0,0,0,0
9/14/2020,Q3,5,H,Airport,Arrival,656,4,26,686
9/14/2020,Q3,5,H,Airport,Departure,866,8,38,912
9/14/2020,Q3,5,H,Express Rail Link West Kowloon,Arrival,0,0,0,0
9/14/2020,Q3,5,H,Express Rail Link West Kowloon,Departure,0,0,0,0
9/14/2020,Q3,5,H,Hung Hom,Arrival,0,0,0,0
9/14/2020,Q3,5,H,Hung Hom,Departure,0,0,0,0
9/14/2020,Q3,5,H,Lo Wu,Arrival,0,0,0,0
9/14/2020,Q3,5,H,Lo Wu,Departure,0,0,0,0
9/14/2020,Q3,5,H,Lok Ma Chau Spur Line,Arrival,0,0,0,0
9/14/2020,Q3,5,H,Lok Ma Chau Spur Line,Departure,0,0,0,0
9/14/2020,Q3,5,H,Heung Yuen Wai,Arrival,0,0,0,0
9/14/2020,Q3,5,H,Heung Yuen Wai,Departure,0,0,0,0
9/14/2020,Q3,5,H,Hong Kong-Zhuhai-Macao Bridge,Arrival,160,9,3,172
9/14/2020,Q3,5,H,Hong Kong-Zhuhai-Macao Bridge,Departure,87,2,3,92
9/14/2020,Q3,5,H,Lok Ma Chau,Arrival,0,0,0,0
9/14/2020,Q3,5,H,Lok Ma Chau,Departure,0,0,0,0
9/14/2020,Q3,5,H,Man Kam To,Arrival,0,0,0,0
9/14/2020,Q3,5,H,Man Kam To,Departure,0,0,0,0
9/14/2020,Q3,5,H,Sha Tau Kok,Arrival,0,0,0,0
9/14/2020,Q3,5,H,Sha Tau Kok,Departure,0,0,0,0
9/14/2020,Q3,5,H,Shenzhen Bay,Arrival,2277,302,7,2586
9/14/2020,Q3,5,H,Shenzhen Bay,Departure,415,45,4,464
9/14/2020,Q3,5,H,China Ferry Terminal,Arrival,0,0,0,0
9/14/2020,Q3,5,H,China Ferry Terminal,Departure,0,0,0,0
9/14/2020,Q3,5,H,Harbour Control,Arrival,0,0,0,0
9/14/2020,Q3,5,H,Harbour Control,Departure,0,0,0,0
9/14/2020,Q3,5,H,Kai Tak Cruise Terminal,Arrival,0,0,0,0
9/14/2020,Q3,5,H,Kai Tak Cruise Terminal,Departure,0,0,0,0
9/14/2020,Q3,5,H,Macau Ferry Terminal,Arrival,0,0,0,0
9/14/2020,Q3,5,H,Macau Ferry Terminal,Departure,0,0,0,0
9/14/2020,Q3,5,H,Tuen Mun Ferry Terminal,Arrival,0,0,0,0
9/14/2020,Q3,5,H,Tuen Mun Ferry Terminal,Departure,0,0,0,0
9/15/2020,Q3,5,H,Airport,Arrival,754,7,40,801
9/15/2020,Q3,5,H,Airport,Departure,1340,18,64,1422
9/15/2020,Q3,5,H,Express Rail Link West Kowloon,Arrival,0,0,0,0
9/15/2020,Q3,5,H,Express Rail Link West Kowloon,Departure,0,0,0,0
9/15/2020,Q3,5,H,Hung Hom,Arrival,0,0,0,0
9/15/2020,Q3,5,H,Hung Hom,Departure,0,0,0,0
9/15/2020,Q3,5,H,Lo Wu,Arrival,0,0,0,0
9/15/2020,Q3,5,H,Lo Wu,Departure,0,0,0,0
9/15/2020,Q3,5,H,Lok Ma Chau Spur Line,Arrival,0,0,0,0
9/15/2020,Q3,5,H,Lok Ma Chau Spur Line,Departure,0,0,0,0
9/15/2020,Q3,5,H,Heung Yuen Wai,Arrival,0,0,0,0
9/15/2020,Q3,5,H,Heung Yuen Wai,Departure,0,0,0,0
9/15/2020,Q3,5,H,Hong Kong-Zhuhai-Macao Bridge,Arrival,125,6,5,136
9/15/2020,Q3,5,H,Hong Kong-Zhuhai-Macao Bridge,Departure,128,3,3,134
9/15/2020,Q3,5,H,Lok Ma Chau,Arrival,0,0,0,0
9/15/2020,Q3,5,H,Lok Ma Chau,Departure,0,0,0,0
9/15/2020,Q3,5,H,Man Kam To,Arrival,0,0,0,0
9/15/2020,Q3,5,H,Man Kam To,Departure,0,0,0,0
9/15/2020,Q3,5,H,Sha Tau Kok,Arrival,0,0,0,0
9/15/2020,Q3,5,H,Sha Tau Kok,Departure,0,0,0,0
9/15/2020,Q3,5,H,Shenzhen Bay,Arrival,1764,263,9,2036
9/15/2020,Q3,5,H,Shenzhen Bay,Departure,550,51,2,603
9/15/2020,Q3,5,H,China Ferry Terminal,Arrival,0,0,0,0
9/15/2020,Q3,5,H,China Ferry Terminal,Departure,0,0,0,0
9/15/2020,Q3,5,H,Harbour Control,Arrival,0,0,0,0
9/15/2020,Q3,5,H,Harbour Control,Departure,0,0,0,0
9/15/2020,Q3,5,H,Kai Tak Cruise Terminal,Arrival,0,0,0,0
9/15/2020,Q3,5,H,Kai Tak Cruise Terminal,Departure,0,0,0,0
9/15/2020,Q3,5,H,Macau Ferry Terminal,Arrival,0,0,0,0
9/15/2020,Q3,5,H,Macau Ferry Terminal,Departure,0,0,0,0
9/15/2020,Q3,5,H,Tuen Mun Ferry Terminal,Arrival,0,0,0,0
9/15/2020,Q3,5,H,Tuen Mun Ferry Terminal,Departure,0,0,0,0
9/16/2020,Q3,5,H,Airport,Arrival,799,10,30,839
9/16/2020,Q3,5,H,Airport,Departure,1065,17,47,1129
9/16/2020,Q3,5,H,Express Rail Link West Kowloon,Arrival,0,0,0,0
9/16/2020,Q3,5,H,Express Rail Link West Kowloon,Departure,0,0,0,0
9/16/2020,Q3,5,H,Hung Hom,Arrival,0,0,0,0
9/16/2020,Q3,5,H,Hung Hom,Departure,0,0,0,0
9/16/2020,Q3,5,H,Lo Wu,Arrival,0,0,0,0
9/16/2020,Q3,5,H,Lo Wu,Departure,0,0,0,0
9/16/2020,Q3,5,H,Lok Ma Chau Spur Line,Arrival,0,0,0,0
9/16/2020,Q3,5,H,Lok Ma Chau Spur Line,Departure,0,0,0,0
9/16/2020,Q3,5,H,Heung Yuen Wai,Arrival,0,0,0,0
9/16/2020,Q3,5,H,Heung Yuen Wai,Departure,0,0,0,0
9/16/2020,Q3,5,H,Hong Kong-Zhuhai-Macao Bridge,Arrival,73,3,2,78
9/16/2020,Q3,5,H,Hong Kong-Zhuhai-Macao Bridge,Departure,321,11,7,339
9/16/2020,Q3,5,H,Lok Ma Chau,Arrival,0,0,0,0
9/16/2020,Q3,5,H,Lok Ma Chau,Departure,0,0,0,0
9/16/2020,Q3,5,H,Man Kam To,Arrival,0,0,0,0
9/16/2020,Q3,5,H,Man Kam To,Departure,0,0,0,0
9/16/2020,Q3,5,H,Sha Tau Kok,Arrival,0,0,0,0
9/16/2020,Q3,5,H,Sha Tau Kok,Departure,0,0,0,0
9/16/2020,Q3,5,H,Shenzhen Bay,Arrival,1091,183,5,1279
9/16/2020,Q3,5,H,Shenzhen Bay,Departure,1189,85,5,1279
9/16/2020,Q3,5,H,China Ferry Terminal,Arrival,0,0,0,0
9/16/2020,Q3,5,H,China Ferry Terminal,Departure,0,0,0,0
9/16/2020,Q3,5,H,Harbour Control,Arrival,0,0,0,0
9/16/2020,Q3,5,H,Harbour Control,Departure,0,0,0,0
9/16/2020,Q3,5,H,Kai Tak Cruise Terminal,Arrival,0,0,0,0
9/16/2020,Q3,5,H,Kai Tak Cruise Terminal,Departure,0,0,0,0
9/16/2020,Q3,5,H,Macau Ferry Terminal,Arrival,0,0,0,0
9/16/2020,Q3,5,H,Macau Ferry Terminal,Departure,0,0,0,0
9/16/2020,Q3,5,H,Tuen Mun Ferry Terminal,Arrival,0,0,0,0
9/16/2020,Q3,5,H,Tuen Mun Ferry Terminal,Departure,0,0,0,0
9/17/2020,Q3,5,H,Airport,Arrival,650,5,21,676
9/17/2020,Q3,5,H,Airport,Departure,1276,6,42,1324
9/17/2020,Q3,5,H,Express Rail Link West Kowloon,Arrival,0,0,0,0
9/17/2020,Q3,5,H,Express Rail Link West Kowloon,Departure,0,0,0,0
9/17/2020,Q3,5,H,Hung Hom,Arrival,0,0,0,0
9/17/2020,Q3,5,H,Hung Hom,Departure,0,0,0,0
9/17/2020,Q3,5,H,Lo Wu,Arrival,0,0,0,0
9/17/2020,Q3,5,H,Lo Wu,Departure,0,0,0,0
9/17/2020,Q3,5,H,Lok Ma Chau Spur Line,Arrival,0,0,0,0
9/17/2020,Q3,5,H,Lok Ma Chau Spur Line,Departure,0,0,0,0
9/17/2020,Q3,5,H,Heung Yuen Wai,Arrival,0,0,0,0
9/17/2020,Q3,5,H,Heung Yuen Wai,Departure,0,0,0,0
9/17/2020,Q3,5,H,Hong Kong-Zhuhai-Macao Bridge,Arrival,72,4,1,77
9/17/2020,Q3,5,H,Hong Kong-Zhuhai-Macao Bridge,Departure,87,9,4,100
9/17/2020,Q3,5,H,Lok Ma Chau,Arrival,0,0,0,0
9/17/2020,Q3,5,H,Lok Ma Chau,Departure,0,0,0,0
9/17/2020,Q3,5,H,Man Kam To,Arrival,0,0,0,0
9/17/2020,Q3,5,H,Man Kam To,Departure,0,0,0,0
9/17/2020,Q3,5,H,Sha Tau Kok,Arrival,0,0,0,0
9/17/2020,Q3,5,H,Sha Tau Kok,Departure,0,0,0,0
9/17/2020,Q3,5,H,Shenzhen Bay,Arrival,844,103,0,947
9/17/2020,Q3,5,H,Shenzhen Bay,Departure,459,37,3,499
9/17/2020,Q3,5,H,China Ferry Terminal,Arrival,0,0,0,0
9/17/2020,Q3,5,H,China Ferry Terminal,Departure,0,0,0,0
9/17/2020,Q3,5,H,Harbour Control,Arrival,0,0,0,0
9/17/2020,Q3,5,H,Harbour Control,Departure,0,0,0,0
9/17/2020,Q3,5,H,Kai Tak Cruise Terminal,Arrival,0,0,0,0
9/17/2020,Q3,5,H,Kai Tak Cruise Terminal,Departure,0,0,0,0
9/17/2020,Q3,5,H,Macau Ferry Terminal,Arrival,0,0,0,0
9/17/2020,Q3,5,H,Macau Ferry Terminal,Departure,0,0,0,0
9/17/2020,Q3,5,H,Tuen Mun Ferry Terminal,Arrival,0,0,0,0
9/17/2020,Q3,5,H,Tuen Mun Ferry Terminal,Departure,0,0,0,0
9/18/2020,Q3,5,H,Airport,Arrival,822,4,41,867
9/18/2020,Q3,5,H,Airport,Departure,1336,5,41,1382
9/18/2020,Q3,5,H,Express Rail Link West Kowloon,Arrival,0,0,0,0
9/18/2020,Q3,5,H,Express Rail Link West Kowloon,Departure,0,0,0,0
9/18/2020,Q3,5,H,Hung Hom,Arrival,0,0,0,0
9/18/2020,Q3,5,H,Hung Hom,Departure,0,0,0,0
9/18/2020,Q3,5,H,Lo Wu,Arrival,0,0,0,0
9/18/2020,Q3,5,H,Lo Wu,Departure,0,0,0,0
9/18/2020,Q3,5,H,Lok Ma Chau Spur Line,Arrival,0,0,0,0
9/18/2020,Q3,5,H,Lok Ma Chau Spur Line,Departure,0,0,0,0
9/18/2020,Q3,5,H,Heung Yuen Wai,Arrival,0,0,0,0
9/18/2020,Q3,5,H,Heung Yuen Wai,Departure,0,0,0,0
9/18/2020,Q3,5,H,Hong Kong-Zhuhai-Macao Bridge,Arrival,75,11,3,89
9/18/2020,Q3,5,H,Hong Kong-Zhuhai-Macao Bridge,Departure,72,2,1,75
9/18/2020,Q3,5,H,Lok Ma Chau,Arrival,0,0,0,0
9/18/2020,Q3,5,H,Lok Ma Chau,Departure,0,0,0,0
9/18/2020,Q3,5,H,Man Kam To,Arrival,0,0,0,0
9/18/2020,Q3,5,H,Man Kam To,Departure,0,0,0,0
9/18/2020,Q3,5,H,Sha Tau Kok,Arrival,0,0,0,0
9/18/2020,Q3,5,H,Sha Tau Kok,Departure,0,0,0,0
9/18/2020,Q3,5,H,Shenzhen Bay,Arrival,868,121,4,993
9/18/2020,Q3,5,H,Shenzhen Bay,Departure,393,48,11,452
9/18/2020,Q3,5,H,China Ferry Terminal,Arrival,0,0,0,0
9/18/2020,Q3,5,H,China Ferry Terminal,Departure,0,0,0,0
9/18/2020,Q3,5,H,Harbour Control,Arrival,0,0,0,0
9/18/2020,Q3,5,H,Harbour Control,Departure,0,0,0,0
9/18/2020,Q3,5,H,Kai Tak Cruise Terminal,Arrival,0,0,0,0
9/18/2020,Q3,5,H,Kai Tak Cruise Terminal,Departure,0,0,0,0
9/18/2020,Q3,5,H,Macau Ferry Terminal,Arrival,0,0,0,0
9/18/2020,Q3,5,H,Macau Ferry Terminal,Departure,0,0,0,0
9/18/2020,Q3,5,H,Tuen Mun Ferry Terminal,Arrival,0,0,0,0
9/18/2020,Q3,5,H,Tuen Mun Ferry Terminal,Departure,0,0,0,0
9/19/2020,Q3,5,H,Airport,Arrival,1306,11,31,1348
9/19/2020,Q3,5,H,Airport,Departure,1544,25,36,1605
9/19/2020,Q3,5,H,Express Rail Link West Kowloon,Arrival,0,0,0,0
9/19/2020,Q3,5,H,Express Rail Link West Kowloon,Departure,0,0,0,0
9/19/2020,Q3,5,H,Hung Hom,Arrival,0,0,0,0
9/19/2020,Q3,5,H,Hung Hom,Departure,0,0,0,0
9/19/2020,Q3,5,H,Lo Wu,Arrival,0,0,0,0
9/19/2020,Q3,5,H,Lo Wu,Departure,0,0,0,0
9/19/2020,Q3,5,H,Lok Ma Chau Spur Line,Arrival,0,0,0,0
9/19/2020,Q3,5,H,Lok Ma Chau Spur Line,Departure,0,0,0,0
9/19/2020,Q3,5,H,Heung Yuen Wai,Arrival,0,0,0,0
9/19/2020,Q3,5,H,Heung Yuen Wai,Departure,0,0,0,0
9/19/2020,Q3,5,H,Hong Kong-Zhuhai-Macao Bridge,Arrival,114,9,4,127
9/19/2020,Q3,5,H,Hong Kong-Zhuhai-Macao Bridge,Departure,82,6,5,93
9/19/2020,Q3,5,H,Lok Ma Chau,Arrival,0,0,0,0
9/19/2020,Q3,5,H,Lok Ma Chau,Departure,0,0,0,0
9/19/2020,Q3,5,H,Man Kam To,Arrival,0,0,0,0
9/19/2020,Q3,5,H,Man Kam To,Departure,0,0,0,0
9/19/2020,Q3,5,H,Sha Tau Kok,Arrival,0,0,0,0
9/19/2020,Q3,5,H,Sha Tau Kok,Departure,0,0,0,0
9/19/2020,Q3,5,H,Shenzhen Bay,Arrival,1236,202,4,1442
9/19/2020,Q3,5,H,Shenzhen Bay,Departure,357,52,6,415
9/19/2020,Q3,5,H,China Ferry Terminal,Arrival,0,0,0,0
9/19/2020,Q3,5,H,China Ferry Terminal,Departure,0,0,0,0
9/19/2020,Q3,5,H,Harbour Control,Arrival,0,0,0,0
9/19/2020,Q3,5,H,Harbour Control,Departure,0,0,0,0
9/19/2020,Q3,5,H,Kai Tak Cruise Terminal,Arrival,0,0,0,0
9/19/2020,Q3,5,H,Kai Tak Cruise Terminal,Departure,0,0,0,0
9/19/2020,Q3,5,H,Macau Ferry Terminal,Arrival,0,0,0,0
9/19/2020,Q3,5,H,Macau Ferry Terminal,Departure,0,0,0,0
9/19/2020,Q3,5,H,Tuen Mun Ferry Terminal,Arrival,0,0,0,0
9/19/2020,Q3,5,H,Tuen Mun Ferry Terminal,Departure,0,0,0,0
9/20/2020,Q3,5,H,Airport,Arrival,1171,9,43,1223
9/20/2020,Q3,5,H,Airport,Departure,1292,21,48,1361
9/20/2020,Q3,5,H,Express Rail Link West Kowloon,Arrival,0,0,0,0
9/20/2020,Q3,5,H,Express Rail Link West Kowloon,Departure,0,0,0,0
9/20/2020,Q3,5,H,Hung Hom,Arrival,0,0,0,0
9/20/2020,Q3,5,H,Hung Hom,Departure,0,0,0,0
9/20/2020,Q3,5,H,Lo Wu,Arrival,0,0,0,0
9/20/2020,Q3,5,H,Lo Wu,Departure,0,0,0,0
9/20/2020,Q3,5,H,Lok Ma Chau Spur Line,Arrival,0,0,0,0
9/20/2020,Q3,5,H,Lok Ma Chau Spur Line,Departure,0,0,0,0
9/20/2020,Q3,5,H,Heung Yuen Wai,Arrival,0,0,0,0
9/20/2020,Q3,5,H,Heung Yuen Wai,Departure,0,0,0,0
9/20/2020,Q3,5,H,Hong Kong-Zhuhai-Macao Bridge,Arrival,144,16,5,165
9/20/2020,Q3,5,H,Hong Kong-Zhuhai-Macao Bridge,Departure,50,5,1,56
9/20/2020,Q3,5,H,Lok Ma Chau,Arrival,0,0,0,0
9/20/2020,Q3,5,H,Lok Ma Chau,Departure,0,0,0,0
9/20/2020,Q3,5,H,Man Kam To,Arrival,0,0,0,0
9/20/2020,Q3,5,H,Man Kam To,Departure,0,0,0,0
9/20/2020,Q3,5,H,Sha Tau Kok,Arrival,0,0,0,0
9/20/2020,Q3,5,H,Sha Tau Kok,Departure,0,0,0,0
9/20/2020,Q3,5,H,Shenzhen Bay,Arrival,2339,314,9,2662
9/20/2020,Q3,5,H,Shenzhen Bay,Departure,313,26,6,345
9/20/2020,Q3,5,H,China Ferry Terminal,Arrival,0,0,0,0
9/20/2020,Q3,5,H,China Ferry Terminal,Departure,0,0,0,0
9/20/2020,Q3,5,H,Harbour Control,Arrival,0,0,0,0
9/20/2020,Q3,5,H,Harbour Control,Departure,0,0,0,0
9/20/2020,Q3,5,H,Kai Tak Cruise Terminal,Arrival,0,0,0,0
9/20/2020,Q3,5,H,Kai Tak Cruise Terminal,Departure,0,0,0,0
9/20/2020,Q3,5,H,Macau Ferry Terminal,Arrival,0,0,0,0
9/20/2020,Q3,5,H,Macau Ferry Terminal,Departure,0,0,0,0
9/20/2020,Q3,5,H,Tuen Mun Ferry Terminal,Arrival,0,0,0,0
9/20/2020,Q3,5,H,Tuen Mun Ferry Terminal,Departure,0,0,0,0
9/21/2020,Q3,5,H,Airport,Arrival,740,1,17,758
9/21/2020,Q3,5,H,Airport,Departure,1110,5,23,1138
9/21/2020,Q3,5,H,Express Rail Link West Kowloon,Arrival,0,0,0,0
9/21/2020,Q3,5,H,Express Rail Link West Kowloon,Departure,0,0,0,0
9/21/2020,Q3,5,H,Hung Hom,Arrival,0,0,0,0
9/21/2020,Q3,5,H,Hung Hom,Departure,0,0,0,0
9/21/2020,Q3,5,H,Lo Wu,Arrival,0,0,0,0
9/21/2020,Q3,5,H,Lo Wu,Departure,0,0,0,0
9/21/2020,Q3,5,H,Lok Ma Chau Spur Line,Arrival,0,0,0,0
9/21/2020,Q3,5,H,Lok Ma Chau Spur Line,Departure,0,0,0,0
9/21/2020,Q3,5,H,Heung Yuen Wai,Arrival,0,0,0,0
9/21/2020,Q3,5,H,Heung Yuen Wai,Departure,0,0,0,0
9/21/2020,Q3,5,H,Hong Kong-Zhuhai-Macao Bridge,Arrival,119,9,1,129
9/21/2020,Q3,5,H,Hong Kong-Zhuhai-Macao Bridge,Departure,44,1,3,48
9/21/2020,Q3,5,H,Lok Ma Chau,Arrival,0,0,0,0
9/21/2020,Q3,5,H,Lok Ma Chau,Departure,0,0,0,0
9/21/2020,Q3,5,H,Man Kam To,Arrival,0,0,0,0
9/21/2020,Q3,5,H,Man Kam To,Departure,0,0,0,0
9/21/2020,Q3,5,H,Sha Tau Kok,Arrival,0,0,0,0
9/21/2020,Q3,5,H,Sha Tau Kok,Departure,0,0,0,0
9/21/2020,Q3,5,H,Shenzhen Bay,Arrival,1398,204,3,1605
9/21/2020,Q3,5,H,Shenzhen Bay,Departure,296,39,3,338
9/21/2020,Q3,5,H,China Ferry Terminal,Arrival,0,0,0,0
9/21/2020,Q3,5,H,China Ferry Terminal,Departure,0,0,0,0
9/21/2020,Q3,5,H,Harbour Control,Arrival,0,0,0,0
9/21/2020,Q3,5,H,Harbour Control,Departure,0,0,0,0
9/21/2020,Q3,5,H,Kai Tak Cruise Terminal,Arrival,0,0,0,0
9/21/2020,Q3,5,H,Kai Tak Cruise Terminal,Departure,0,0,0,0
9/21/2020,Q3,5,H,Macau Ferry Terminal,Arrival,0,0,0,0
9/21/2020,Q3,5,H,Macau Ferry Terminal,Departure,0,0,0,0
9/21/2020,Q3,5,H,Tuen Mun Ferry Terminal,Arrival,0,0,0,0
9/21/2020,Q3,5,H,Tuen Mun Ferry Terminal,Departure,0,0,0,0
9/22/2020,Q3,5,H,Airport,Arrival,740,2,21,763
9/22/2020,Q3,5,H,Airport,Departure,1109,22,57,1188
9/22/2020,Q3,5,H,Express Rail Link West Kowloon,Arrival,0,0,0,0
9/22/2020,Q3,5,H,Express Rail Link West Kowloon,Departure,0,0,0,0
9/22/2020,Q3,5,H,Hung Hom,Arrival,0,0,0,0
9/22/2020,Q3,5,H,Hung Hom,Departure,0,0,0,0
9/22/2020,Q3,5,H,Lo Wu,Arrival,0,0,0,0
9/22/2020,Q3,5,H,Lo Wu,Departure,0,0,0,0
9/22/2020,Q3,5,H,Lok Ma Chau Spur Line,Arrival,0,0,0,0
9/22/2020,Q3,5,H,Lok Ma Chau Spur Line,Departure,0,0,0,0
9/22/2020,Q3,5,H,Heung Yuen Wai,Arrival,0,0,0,0
9/22/2020,Q3,5,H,Heung Yuen Wai,Departure,0,0,0,0
9/22/2020,Q3,5,H,Hong Kong-Zhuhai-Macao Bridge,Arrival,104,5,2,111
9/22/2020,Q3,5,H,Hong Kong-Zhuhai-Macao Bridge,Departure,102,6,1,109
9/22/2020,Q3,5,H,Lok Ma Chau,Arrival,0,0,0,0
9/22/2020,Q3,5,H,Lok Ma Chau,Departure,0,0,0,0
9/22/2020,Q3,5,H,Man Kam To,Arrival,0,0,0,0
9/22/2020,Q3,5,H,Man Kam To,Departure,0,0,0,0
9/22/2020,Q3,5,H,Sha Tau Kok,Arrival,0,0,0,0
9/22/2020,Q3,5,H,Sha Tau Kok,Departure,0,0,0,0
9/22/2020,Q3,5,H,Shenzhen Bay,Arrival,950,129,3,1082
9/22/2020,Q3,5,H,Shenzhen Bay,Departure,373,32,7,412
9/22/2020,Q3,5,H,China Ferry Terminal,Arrival,0,0,0,0
9/22/2020,Q3,5,H,China Ferry Terminal,Departure,0,0,0,0
9/22/2020,Q3,5,H,Harbour Control,Arrival,0,0,0,0
9/22/2020,Q3,5,H,Harbour Control,Departure,0,0,0,0
9/22/2020,Q3,5,H,Kai Tak Cruise Terminal,Arrival,0,0,0,0
9/22/2020,Q3,5,H,Kai Tak Cruise Terminal,Departure,0,0,0,0
9/22/2020,Q3,5,H,Macau Ferry Terminal,Arrival,0,0,0,0
9/22/2020,Q3,5,H,Macau Ferry Terminal,Departure,0,0,0,0
9/22/2020,Q3,5,H,Tuen Mun Ferry Terminal,Arrival,0,0,0,0
9/22/2020,Q3,5,H,Tuen Mun Ferry Terminal,Departure,0,0,0,0
